dt_today,sitetitle,sitelink,pre_click,new_clicks,difrnce
03:04:2014,5stargarciniacambogia,http://click2hit.com/5stargarciniacambogia,81,82,-1
03:04:2014,Adrenalast,http://click2hit.com/Adrenalast,546,546,0
03:04:2014,Anataflex,http://click2hit.com/Anataflex,1274,1280,-6
03:04:2014,Diabetix,http://click2hit.com/Diabetix,723,724,-1
03:04:2014,Equinox,http://click2hit.com/Equinox,8460,8504,-44
03:04:2014,LuxeCoat,http://click2hit.com/LuxeCoat,408,409,-1
03:04:2014,NOX360,http://click2hit.com/NOX360,50,50,0
03:04:2014,Prescopodene,http://click2hit.com/Prescopodene,1345,1347,-2
03:04:2014,Puregarciniaslim,http://click2hit.com/Puregarciniaslim,168,341,-173
03:04:2014,RevoReplex,http://click2hit.com/RevoReplex,203,2,201
03:04:2014,absoluteraspberryketone,http://click2hit.com/absoluteraspberryketone,871,872,-1
03:04:2014,acaiberrypuremax,http://click2hit.com/acaiberrypuremax,163,168,-5
03:04:2014,actionprowhite,http://click2hit.com/actionprowhite,2707,2748,-41
03:04:2014,activedetoxcleanse,http://click2hit.com/activedetoxcleanse,9,16,-7
03:04:2014,activeraspberryketone,http://click2hit.com/activeraspberryketone,665,693,-28
03:04:2014,advancedgarciniacambogia,http://click2hit.com/advancedgarciniacambogia,778,778,0
03:04:2014,advancedpuregarcinia,http://click2hit.com/advancedpuregarcinia,549,551,-2
03:04:2014,advancedtest,http://click2hit.com/advancedtest,564,567,-3
03:04:2014,advancedtrimgreencoffee,http://click2hit.com/advancedtrimgreencoffee,1666,1670,-4
03:04:2014,africanmangopremier,http://click2hit.com/africanmangopremier,740,742,-2
03:04:2014,agelesshealthsolution,http://click2hit.com/agelesshealthsolution,116,119,-3
03:04:2014,alleureantiagingcream,http://click2hit.com/alleureantiagingcream,38,56,-18
03:04:2014,alleureeyeserum,http://click2hit.com/alleureeyeserum,31,58,-27
03:04:2014,aloeferoxcleanse,http://click2hit.com/aloeferoxcleanse,1238,1255,-17
03:04:2014,aloeveracleanse,http://click2hit.com/aloeveracleanse,627,632,-5
03:04:2014,alore,http://click2hit.com/alore,3827,3838,-11
03:04:2014,alphacuthd,http://click2hit.com/alphacuthd,36,38,-2
03:04:2014,alphagenix,http://click2hit.com/alphagenix,4017,4,4013
03:04:2014,alphamale,http://click2hit.com/alphamale,197,197,0
03:04:2014,alphamax1,http://click2hit.com/alphamax1,248,249,-1
03:04:2014,amacari,http://click2hit.com/amacari,151,151,0
03:04:2014,amazingcleanse,http://click2hit.com/amazingcleanse,2,2,0
03:04:2014,ambitrimrx,http://click2hit.com/ambitrimrx,769,770,-1
03:04:2014,amino,http://click2hit.com/amino,1266,1267,-1
03:04:2014,andromale,http://click2hit.com/andromale,527,532,-5
03:04:2014,anoradrol,http://click2hit.com/anoradrol,85,85,0
03:04:2014,aussiegarciniacambogia,http://click2hit.com/aussiegarciniacambogia,156,157,-1
03:04:2014,authenticgarciniacambogia,http://click2hit.com/authenticgarciniacambogia,64,65,-1
03:04:2014,beaute,http://click2hit.com/beaute,644,645,-1
03:04:2014,bellaathome,http://click2hit.com/bellaathome,1750,1751,-1
03:04:2014,bellapure,http://click2hit.com/bellapure,1641,1659,-18
03:04:2014,bellecomplex,http://click2hit.com/bellecomplex,631,635,-4
03:04:2014,berryherbalcleanse,http://click2hit.com/berryherbalcleanse,570,570,0
03:04:2014,berrythingarciniacambogia,http://click2hit.com/berrythingarciniacambogia,540,540,0
03:04:2014,betaalalinemax,http://click2hit.com/betaalalinemax,567,567,0
03:04:2014,betaboost,http://click2hit.com/betaboost,106,106,0
03:04:2014,betaforce,http://click2hit.com/betaforce,652,653,-1
03:04:2014,beyondraspberryketone,http://click2hit.com/beyondraspberryketone,2098,2098,0
03:04:2014,biocareslimplus,http://click2hit.com/biocareslimplus,312,312,0
03:04:2014,biocarexl,http://click2hit.com/biocarexl,325,325,0
03:04:2014,biogeniste,http://click2hit.com/biogeniste,447,447,0
03:04:2014,blackbullmaleenhancement,http://click2hit.com/blackbullmaleenhancement,1450,1450,0
03:04:2014,blackdiamond,http://click2hit.com/blackdiamond,362,382,-20
03:04:2014,blacklineelite,http://click2hit.com/blacklineelite,1337,1361,-24
03:04:2014,blastxl,http://click2hit.com/blastxl,142,142,0
03:04:2014,blizzadwhite,http://click2hit.com/blizzadwhite,2373,2402,-29
03:04:2014,bluemagicplus,http://click2hit.com/bluemagicplus,856,863,-7
03:04:2014,bodyfuelxs,http://click2hit.com/bodyfuelxs,87,87,0
03:04:2014,brandnew,http://click2hit.com/brandnew,348,350,-2
03:04:2014,brandnewbooty,http://click2hit.com/brandnewbooty,763,766,-3
03:04:2014,cafevertextraminceur,http://click2hit.com/cafevertextraminceur,1809,1905,-96
03:04:2014,carbuloss,http://click2hit.com/carbuloss,335,337,-2
03:04:2014,celebritybodynow,http://click2hit.com/celebritybodynow,418,418,0
03:04:2014,celebrityweightlosskit,http://click2hit.com/celebrityweightlosskit,359,359,0
03:04:2014,cellanafricanmango,http://click2hit.com/cellanafricanmango,1449,1595,-146
03:04:2014,cellogicaskin,http://click2hit.com/cellogicaskin,164,167,-3
03:04:2014,cenaless,http://click2hit.com/cenaless,75,75,0
03:04:2014,cenaslim,http://click2hit.com/cenaslim,378,380,-2
03:04:2014,cleandetox,http://click2hit.com/cleandetox,269,269,0
03:04:2014,cleansecatalystplus,http://click2hit.com/cleansecatalystplus,3258,3275,-17
03:04:2014,cleanseultimo,http://click2hit.com/cleanseultimo,1390,1396,-6
03:04:2014,cocogeniceyeserum,http://click2hit.com/cocogeniceyeserum,69,4,65
03:04:2014,coffeecleansemax,http://click2hit.com/coffeecleansemax,378,379,-1
03:04:2014,coffeepurecleanse,http://click2hit.com/coffeepurecleanse,36,41,-5
03:04:2014,coleanse,http://click2hit.com/coleanse,2020,2037,-17
03:04:2014,collagen,http://click2hit.com/collagen,817,2,815
03:04:2014,collagenfaceserum,http://click2hit.com/collagenfaceserum,40,41,-1
03:04:2014,colodetox,http://click2hit.com/colodetox,523,528,-5
03:04:2014,colodetoxplus,http://click2hit.com/colodetoxplus,89,91,-2
03:04:2014,coloncleanse1300,http://click2hit.com/coloncleanse1300,280,280,0
03:04:2014,coloncleansecomplete,http://click2hit.com/coloncleansecomplete,1275,1277,-2
03:04:2014,coloncleansetotal,http://click2hit.com/coloncleansetotal,761,765,-4
03:04:2014,colondetoxpro,http://click2hit.com/colondetoxpro,7,13,-6
03:04:2014,colonpurecleanse,http://click2hit.com/colonpurecleanse,404,404,0
03:04:2014,colothin,http://click2hit.com/colothin,188,189,-1
03:04:2014,columbiangreencoffeebean,http://click2hit.com/columbiangreencoffeebean,711,717,-6
03:04:2014,combogiaplus,http://click2hit.com/combogiaplus,327,328,-1
03:04:2014,completecoffeecleanse,http://click2hit.com/completecoffeecleanse,391,394,-3
03:04:2014,complexiderm,http://click2hit.com/complexiderm,186,186,0
03:04:2014,cosimarevival,http://click2hit.com/cosimarevival,181,182,-1
03:04:2014,cosmitone,http://click2hit.com/cosmitone,1327,1329,-2
03:04:2014,csorex,http://click2hit.com/csorex,105,105,0
03:04:2014,curcovia,http://click2hit.com/curcovia,423,424,-1
03:04:2014,cutiecurves,http://click2hit.com/cutiecurves,245,246,-1
03:04:2014,cytotrim,http://click2hit.com/cytotrim,1870,1871,-1
03:04:2014,dailyeyerestoration,http://click2hit.com/dailyeyerestoration,132,134,-2
03:04:2014,dellure,http://click2hit.com/dellure,113,114,-1
03:04:2014,dellurecollagen,http://click2hit.com/dellurecollagen,565,568,-3
03:04:2014,dermafirm,http://click2hit.com/dermafirm,756,757,-1
03:04:2014,dermajuvenate,http://click2hit.com/dermajuvenate,2265,2279,-14
03:04:2014,dermalift,http://click2hit.com/dermalift,235,235,0
03:04:2014,dermallo,http://click2hit.com/dermallo,267,268,-1
03:04:2014,dermalmeds,http://click2hit.com/dermalmeds,441,441,0
03:04:2014,dermangelie,http://click2hit.com/dermangelie,150,150,0
03:04:2014,derminelift,http://click2hit.com/derminelift,402,402,0
03:04:2014,dermology,http://click2hit.com/dermology,40,40,0
03:04:2014,detoxmax,http://click2hit.com/detoxmax,46,48,-2
03:04:2014,dietultimo,http://click2hit.com/dietultimo,2464,2478,-14
03:04:2014,digestItcoloncleanse,http://click2hit.com/digestItcoloncleanse,59,59,0
03:04:2014,duplicellp199,http://click2hit.com/duplicellp199,29,30,-1
03:04:2014,duplicellp199facetherapy,http://click2hit.com/duplicellp199facetherapy,28,29,-1
03:04:2014,ecoflex,http://click2hit.com/ecoflex,122,123,-1
03:04:2014,electravx,http://click2hit.com/electravx,177,178,-1
03:04:2014,elevategf,http://click2hit.com/elevategf,261,263,-2
03:04:2014,elite360,http://click2hit.com/elite360,66,67,-1
03:04:2014,elliskin,http://click2hit.com/elliskin,495,496,-1
03:04:2014,endorev,http://click2hit.com/endorev,455,459,-4
03:04:2014,ephedrix,http://click2hit.com/ephedrix,225,226,-1
03:04:2014,equivita,http://click2hit.com/equivita,7589,7628,-39
03:04:2014,essentialdetox,http://click2hit.com/essentialdetox,422,423,-1
03:04:2014,extagen,http://click2hit.com/extagen,312,313,-1
03:04:2014,extremefx,http://click2hit.com/extremefx,331,339,-8
03:04:2014,eyeluminous,http://click2hit.com/eyeluminous,532,542,-10
03:04:2014,fembalance,http://click2hit.com/fembalance,360,360,0
03:04:2014,firmativ,http://click2hit.com/firmativ,703,716,-13
03:04:2014,flawlessbeauty,http://click2hit.com/flawlessbeauty,70,76,-6
03:04:2014,flexwell,http://click2hit.com/flexwell,101,101,0
03:04:2014,forceeffect,http://click2hit.com/forceeffect,18,56,-38
03:04:2014,formularezvmagic,http://click2hit.com/formularezvmagic,231,231,0
03:04:2014,fortdietmax,http://click2hit.com/fortdietmax,79,79,0
03:04:2014,fortmaxdiet,http://click2hit.com/fortmaxdiet,70,70,0
03:04:2014,garciniaberrythin,http://click2hit.com/garciniaberrythin,475,477,-2
03:04:2014,garciniacambogia1300,http://click2hit.com/garciniacambogia1300,650,650,0
03:04:2014,garciniacambogia360,http://click2hit.com/garciniacambogia360,9,10,-1
03:04:2014,garciniacambogia500,http://click2hit.com/garciniacambogia500,2,2,0
03:04:2014,garciniacambogiablast,http://click2hit.com/garciniacambogiablast,688,698,-10
03:04:2014,garciniacambogiaburn,http://click2hit.com/garciniacambogiaburn,92,92,0
03:04:2014,garciniacambogiacomplex,http://click2hit.com/garciniacambogiacomplex,323,326,-3
03:04:2014,garciniacambogiaextract,http://click2hit.com/garciniacambogiaextract,47,47,0
03:04:2014,garciniacambogiafit1300,http://click2hit.com/garciniacambogiafit1300,114,118,-4
03:04:2014,garciniacambogiaformula,http://click2hit.com/garciniacambogiaformula,23,26,-3
03:04:2014,garciniacambogiahca,http://click2hit.com/garciniacambogiahca,225,227,-2
03:04:2014,garciniacambogiaplus,http://click2hit.com/garciniacambogiaplus,1124,1131,-7
03:04:2014,garciniacambogiapro,http://click2hit.com/garciniacambogiapro,10,13,-3
03:04:2014,garciniacambogiaselect,http://click2hit.com/garciniacambogiaselect,485,485,0
03:04:2014,garciniacambogiaslimfast,http://click2hit.com/garciniacambogiaslimfast,1772,1777,-5
03:04:2014,garciniacambogiaslimsystem,http://click2hit.com/garciniacambogiaslimsystem,1066,1088,-22
03:04:2014,garciniacambogiaxt,http://click2hit.com/garciniacambogiaxt,112,126,-14
03:04:2014,garciniacambogiaz,http://click2hit.com/garciniacambogiaz,66,68,-2
03:04:2014,garciniacombogiasupreme,http://click2hit.com/garciniacombogiasupreme,22,22,0
03:04:2014,garciniadietmax,http://click2hit.com/garciniadietmax,289,306,-17
03:04:2014,garciniaextractplus,http://click2hit.com/garciniaextractplus,229,230,-1
03:04:2014,garciniaforte,http://click2hit.com/garciniaforte,167,167,0
03:04:2014,garciniahca,http://click2hit.com/garciniahca,138,139,-1
03:04:2014,garciniahcapremium,http://click2hit.com/garciniahcapremium,87,92,-5
03:04:2014,garciniaplus,http://click2hit.com/garciniaplus,1947,1952,-5
03:04:2014,garciniasuperdiet,http://click2hit.com/garciniasuperdiet,170,171,-1
03:04:2014,garciniawonder,http://click2hit.com/garciniawonder,763,769,-6
03:04:2014,garciniawow,http://click2hit.com/garciniawow,64,65,-1
03:04:2014,garciniaxslim,http://click2hit.com/garciniaxslim,374,427,-53
03:04:2014,gc180xt,http://click2hit.com/gc180xt,522,535,-13
03:04:2014,gcbmaxgreencoffee,http://click2hit.com/gcbmaxgreencoffee,340,341,-1
03:04:2014,gcfitsgarcinia,http://click2hit.com/gcfitsgarcinia,4,4,0
03:04:2014,gcxsdiet,http://click2hit.com/gcxsdiet,28,29,-1
03:04:2014,genesis,http://click2hit.com/genesis,37,38,-1
03:04:2014,gogiberryburn,http://click2hit.com/gogiberryburn,230,240,-10
03:04:2014,gojiactives,http://click2hit.com/gojiactives,1441,1450,-9
03:04:2014,gojiadvance,http://click2hit.com/gojiadvance,376,379,-3
03:04:2014,gojimax,http://click2hit.com/gojimax,225,232,-7
03:04:2014,gojislim,http://click2hit.com/gojislim,20050,20092,-42
03:04:2014,govapor,http://click2hit.com/govapor,42,54,-12
03:04:2014,greencoffeebeanthin,http://click2hit.com/greencoffeebeanthin,278,278,0
03:04:2014,greencoffeebody,http://click2hit.com/greencoffeebody,411,414,-3
03:04:2014,greencoffeecleanse,http://click2hit.com/greencoffeecleanse,15,16,-1
03:04:2014,greencoffeecleanse1,http://click2hit.com/greencoffeecleanse1,20,24,-4
03:04:2014,greencoffeecleanses,http://click2hit.com/greencoffeecleanses,625,671,-46
03:04:2014,greencoffeeextraslim,http://click2hit.com/greencoffeeextraslim,268,269,-1
03:04:2014,greencoffeefatburn,http://click2hit.com/greencoffeefatburn,1556,1557,-1
03:04:2014,greencoffeenaxx,http://click2hit.com/greencoffeenaxx,194,194,0
03:04:2014,greencoffeeplus,http://click2hit.com/greencoffeeplus,100,100,0
03:04:2014,greencoffeeprogram,http://click2hit.com/greencoffeeprogram,51,53,-2
03:04:2014,greencoffeerevolution,http://click2hit.com/greencoffeerevolution,15,16,-1
03:04:2014,greencoffeespeedslim,http://click2hit.com/greencoffeespeedslim,1204,1237,-33
03:04:2014,greencoffeesupreme,http://click2hit.com/greencoffeesupreme,339,344,-5
03:04:2014,greencoffeesupremecleanse,http://click2hit.com/greencoffeesupremecleanse,114,114,0
03:04:2014,greendetoxpatch,http://click2hit.com/greendetoxpatch,281,282,-1
03:04:2014,greenleancoffeebean,http://click2hit.com/greenleancoffeebean,204,204,0
03:04:2014,greentonepromuscle,http://click2hit.com/greentonepromuscle,210,212,-2
03:04:2014,growxl,http://click2hit.com/growxl,2682,2685,-3
03:04:2014,hairgenesis,http://click2hit.com/hairgenesis,75,77,-2
03:04:2014,hardknight,http://click2hit.com/hardknight,1403,1415,-12
03:04:2014,hardknight-1,http://click2hit.com/hardknight-1,78,79,-1
03:04:2014,hawaiislim,http://click2hit.com/hawaiislim,133,133,0
03:04:2014,healthycleanse,http://click2hit.com/healthycleanse,507,509,-2
03:04:2014,heboost,http://click2hit.com/heboost,233,233,0
03:04:2014,hghfuel,http://click2hit.com/hghfuel,19,20,-1
03:04:2014,hghpro,http://click2hit.com/hghpro,3903,3913,-10
03:04:2014,hghxl,http://click2hit.com/hghxl,130,130,0
03:04:2014,hight,http://click2hit.com/hight,321,322,-1
03:04:2014,hspactives,http://click2hit.com/hspactives,2125,2132,-7
03:04:2014,htrush,http://click2hit.com/htrush,288,291,-3
03:04:2014,hydradiance,http://click2hit.com/hydradiance,490,495,-5
03:04:2014,hydrafirm,http://click2hit.com/hydrafirm,252,252,0
03:04:2014,hydravella,http://click2hit.com/hydravella,223,223,0
03:04:2014,hydroface,http://click2hit.com/hydroface,615,615,0
03:04:2014,hydroxatone90,http://click2hit.com/hydroxatone90,319,320,-1
03:04:2014,hydroxatonebbcream,http://click2hit.com/hydroxatonebbcream,72,72,0
03:04:2014,idolize,http://click2hit.com/idolize,66,79,-13
03:04:2014,instaleanketones,http://click2hit.com/instaleanketones,694,694,0
03:04:2014,instantderma,http://click2hit.com/instantderma,183,183,0
03:04:2014,instantlift,http://click2hit.com/instantlift,470,471,-1
03:04:2014,juvalife,http://click2hit.com/juvalife,83,85,-2
03:04:2014,juvamend,http://click2hit.com/juvamend,179,179,0
03:04:2014,juvesiio,http://click2hit.com/juvesiio,55,56,-1
03:04:2014,ketoneadvanced,http://click2hit.com/ketoneadvanced,42,53,-11
03:04:2014,ketonepremium,http://click2hit.com/ketonepremium,528,528,0
03:04:2014,kollagen,http://click2hit.com/kollagen,76,76,0
03:04:2014,l-carnitineplus,http://click2hit.com/l-carnitineplus,143,144,-1
03:04:2014,ladermanique,http://click2hit.com/ladermanique,1712,1714,-2
03:04:2014,larginineplus,http://click2hit.com/larginineplus,30,30,0
03:04:2014,leanmusclex,http://click2hit.com/leanmusclex,2,4,-2
03:04:2014,leptizin,http://click2hit.com/leptizin,101,101,0
03:04:2014,lifecell,http://click2hit.com/lifecell,139,140,-1
03:04:2014,liftandglowpro,http://click2hit.com/liftandglowpro,34,35,-1
03:04:2014,liftderma,http://click2hit.com/liftderma,735,741,-6
03:04:2014,liftserumpro,http://click2hit.com/liftserumpro,50,53,-3
03:04:2014,liftvapor,http://click2hit.com/liftvapor,893,893,0
03:04:2014,lipo13,http://click2hit.com/lipo13,635,709,-74
03:04:2014,lipog3,http://click2hit.com/lipog3,180,231,-51
03:04:2014,liposlim,http://click2hit.com/liposlim,206,209,-3
03:04:2014,lisocleanse,http://click2hit.com/lisocleanse,29,47,-18
03:04:2014,lorelia,http://click2hit.com/lorelia,2018,2037,-19
03:04:2014,lumeraeyeserum,http://click2hit.com/lumeraeyeserum,2183,2191,-8
03:04:2014,luminant,http://click2hit.com/luminant,395,396,-1
03:04:2014,luminantskin,http://click2hit.com/luminantskin,411,411,0
03:04:2014,luminique,http://click2hit.com/luminique,81,81,0
03:04:2014,luministeyegel,http://click2hit.com/luministeyegel,208,209,-1
03:04:2014,lunarsleep,http://click2hit.com/lunarsleep,215,222,-7
03:04:2014,lunathin,http://click2hit.com/lunathin,140,140,0
03:04:2014,lxwpro-t,http://click2hit.com/lxwpro-t,4,8,-4
03:04:2014,lysocleanse,http://click2hit.com/lysocleanse,730,734,-4
03:04:2014,massivevitality,http://click2hit.com/massivevitality,24,26,-2
03:04:2014,masspmnight,http://click2hit.com/masspmnight,35,35,0
03:04:2014,maxburncambogia,http://click2hit.com/maxburncambogia,6865,6872,-7
03:04:2014,maxcleanse,http://click2hit.com/maxcleanse,268,269,-1
03:04:2014,maxdetox,http://click2hit.com/maxdetox,374,374,0
03:04:2014,maxgarciniaburn,http://click2hit.com/maxgarciniaburn,245,249,-4
03:04:2014,maxleanx,http://click2hit.com/maxleanx,279,279,0
03:04:2014,maxlight,http://click2hit.com/maxlight,236,237,-1
03:04:2014,maxmuscleblast,http://click2hit.com/maxmuscleblast,33,34,-1
03:04:2014,maxmusclelean,http://click2hit.com/maxmusclelean,46,46,0
03:04:2014,maxtrimraspberryketone,http://click2hit.com/maxtrimraspberryketone,105,105,0
03:04:2014,maxxmale,http://click2hit.com/maxxmale,182,182,0
03:04:2014,maxxtest300,http://click2hit.com/maxxtest300,16,17,-1
03:04:2014,miraclegarciniacambogia1300,http://click2hit.com/miraclegarciniacambogia1300,45,46,-1
03:04:2014,miraclegarciniacambogiarx,http://click2hit.com/miraclegarciniacambogiarx,51,52,-1
03:04:2014,miraclephytoceramides,http://click2hit.com/miraclephytoceramides,2052,2074,-22
03:04:2014,miracleraspberryketone,http://click2hit.com/miracleraspberryketone,20,21,-1
03:04:2014,mitoslim,http://click2hit.com/mitoslim,748,749,-1
03:04:2014,mizulean,http://click2hit.com/mizulean,245,245,0
03:04:2014,musclecorex,http://click2hit.com/musclecorex,514,514,0
03:04:2014,muscleforcex,http://click2hit.com/muscleforcex,88,88,0
03:04:2014,musclekingpro,http://click2hit.com/musclekingpro,301,301,0
03:04:2014,musclemax,http://click2hit.com/musclemax,217,218,-1
03:04:2014,muscleripx,http://click2hit.com/muscleripx,194,195,-1
03:04:2014,musclexedge,http://click2hit.com/musclexedge,523,524,-1
03:04:2014,musclexpro,http://click2hit.com/musclexpro,91,93,-2
03:04:2014,musclezx90,http://click2hit.com/musclezx90,2899,2899,0
03:04:2014,naturalburn,http://click2hit.com/naturalburn,256,258,-2
03:04:2014,naturalcleanse,http://click2hit.com/naturalcleanse,812,812,0
03:04:2014,naturalcoloncleanseelite,http://click2hit.com/naturalcoloncleanseelite,312,312,0
03:04:2014,naturaldiet,http://click2hit.com/naturaldiet,144,145,-1
03:04:2014,naturalgarciniacambogiaburn,http://click2hit.com/naturalgarciniacambogiaburn,224,231,-7
03:04:2014,naturalgreencleanse,http://click2hit.com/naturalgreencleanse,531,539,-8
03:04:2014,naturalgreencoffeeburn,http://click2hit.com/naturalgreencoffeeburn,421,423,-2
03:04:2014,naturalpluscleanse,http://click2hit.com/naturalpluscleanse,117,124,-7
03:04:2014,naturalpurecleanse,http://click2hit.com/naturalpurecleanse,393,393,0
03:04:2014,neucleanseultimate,http://click2hit.com/neucleanseultimate,412,418,-6
03:04:2014,neugarciniacambogia,http://click2hit.com/neugarciniacambogia,11,12,-1
03:04:2014,neuropathysupportformula,http://click2hit.com/neuropathysupportformula,235,238,-3
03:04:2014,newagecleanse,http://click2hit.com/newagecleanse,321,321,0
03:04:2014,newlifecleanse,http://click2hit.com/newlifecleanse,150,154,-4
03:04:2014,nidora,http://click2hit.com/nidora,448,453,-5
03:04:2014,nitricmaxmuscle,http://click2hit.com/nitricmaxmuscle,314,316,-2
03:04:2014,nitricmaxmuscle1,http://click2hit.com/nitricmaxmuscle1,59,60,-1
03:04:2014,nitricpower,http://click2hit.com/nitricpower,410,416,-6
03:04:2014,nitroxin,http://click2hit.com/nitroxin,20,27,-7
03:04:2014,nitroxl,http://click2hit.com/nitroxl,282,282,0
03:04:2014,nitroxpro,http://click2hit.com/nitroxpro,6001,6139,-138
03:04:2014,no2explodeextreme,http://click2hit.com/no2explodeextreme,1474,1479,-5
03:04:2014,no2factor,http://click2hit.com/no2factor,330,330,0
03:04:2014,no2maximus,http://click2hit.com/no2maximus,2293,2306,-13
03:04:2014,no2surge,http://click2hit.com/no2surge,123,160,-37
03:04:2014,nuetrim,http://click2hit.com/nuetrim,427,427,0
03:04:2014,nutraburn10,http://click2hit.com/nutraburn10,94,95,-1
03:04:2014,nutranaturalgarciniacambogia,http://click2hit.com/nutranaturalgarciniacambogia,113,114,-1
03:04:2014,nutridiet,http://click2hit.com/nutridiet,942,951,-9
03:04:2014,nuvagenic,http://click2hit.com/nuvagenic,196,196,0
03:04:2014,nuvie,http://click2hit.com/nuvie,141,149,-8
03:04:2014,nuvocleanse,http://click2hit.com/nuvocleanse,589,591,-2
03:04:2014,nuvoslim,http://click2hit.com/nuvoslim,280,309,-29
03:04:2014,onemoment,http://click2hit.com/onemoment,77,82,-5
03:04:2014,optimalstack,http://click2hit.com/optimalstack,456,458,-2
03:04:2014,organiccleanse,http://click2hit.com/organiccleanse,2,2,0
03:04:2014,organiccleansedetox,http://click2hit.com/organiccleansedetox,41,50,-9
03:04:2014,organicgarciniacambogia,http://click2hit.com/organicgarciniacambogia,193,194,-1
03:04:2014,originalgarciniacambogia,http://click2hit.com/originalgarciniacambogia,43,47,-4
03:04:2014,originalyaconextract,http://click2hit.com/originalyaconextract,150,150,0
03:04:2014,originalyaconsyrup,http://click2hit.com/originalyaconsyrup,52,54,-2
03:04:2014,orvigomax,http://click2hit.com/orvigomax,7,26,-19
03:04:2014,ourgreencleanse,http://click2hit.com/ourgreencleanse,142,142,0
03:04:2014,oxygenius,http://click2hit.com/oxygenius,1295,1305,-10
03:04:2014,pelevoni,http://click2hit.com/pelevoni,315,317,-2
03:04:2014,platinumgarciniacambogia,http://click2hit.com/platinumgarciniacambogia,352,353,-1
03:04:2014,poshcream,http://click2hit.com/poshcream,22,24,-2
03:04:2014,powermax,http://click2hit.com/powermax,148,153,-5
03:04:2014,powerprecision,http://click2hit.com/powerprecision,105,107,-2
03:04:2014,poweruphealthgarcinia,http://click2hit.com/poweruphealthgarcinia,29,60,-31
03:04:2014,premiermangocleanse,http://click2hit.com/premiermangocleanse,202,202,0
03:04:2014,premiumgarciniacambogiaslim,http://click2hit.com/premiumgarciniacambogiaslim,485,570,-85
03:04:2014,premiumgreencoffeebean,http://click2hit.com/premiumgreencoffeebean,206,206,0
03:04:2014,procollagen,http://click2hit.com/procollagen,265,265,0
03:04:2014,procoloncleanse,http://click2hit.com/procoloncleanse,167,167,0
03:04:2014,prodermagenix,http://click2hit.com/prodermagenix,182,183,-1
03:04:2014,prodermagenixplus,http://click2hit.com/prodermagenixplus,253,255,-2
03:04:2014,progain350,http://click2hit.com/progain350,3,3,0
03:04:2014,prolong,http://click2hit.com/prolong,464,495,-31
03:04:2014,prolongz,http://click2hit.com/prolongz,402,415,-13
03:04:2014,promusclecomplex,http://click2hit.com/promusclecomplex,533,534,-1
03:04:2014,pronutragarcinia,http://click2hit.com/pronutragarcinia,51,51,0
03:04:2014,protrim,http://click2hit.com/protrim,1043,1044,-1
03:04:2014,purafit,http://click2hit.com/purafit,362,364,-2
03:04:2014,puragreencoffee,http://click2hit.com/puragreencoffee,286,286,0
03:04:2014,pureberrymax,http://click2hit.com/pureberrymax,266,266,0
03:04:2014,purebiodiet,http://click2hit.com/purebiodiet,630,638,-8
03:04:2014,purecambogiaultra,http://click2hit.com/purecambogiaultra,137,163,-26
03:04:2014,purecambogiaultra-1,http://click2hit.com/purecambogiaultra-1,568,571,-3
03:04:2014,purecambogiaultra2,http://click2hit.com/purecambogiaultra2,170,172,-2
03:04:2014,purecleanse,http://click2hit.com/purecleanse,497,497,0
03:04:2014,purecleansemax,http://click2hit.com/purecleansemax,230,231,-1
03:04:2014,purecolocleanse,http://click2hit.com/purecolocleanse,262,263,-1
03:04:2014,purecoloncleanser,http://click2hit.com/purecoloncleanser,1536,1538,-2
03:04:2014,puregarciniacambogia,http://click2hit.com/puregarciniacambogia,194,195,-1
03:04:2014,puregarciniacambogia-1,http://click2hit.com/puregarciniacambogia-1,7244,7339,-95
03:04:2014,puregarciniacambogiaburn,http://click2hit.com/puregarciniacambogiaburn,2322,2322,0
03:04:2014,puregarciniacambogiaplus,http://click2hit.com/puregarciniacambogiaplus,367,371,-4
03:04:2014,puregarciniacambogiapremium,http://click2hit.com/puregarciniacambogiapremium,1203,1205,-2
03:04:2014,puregarciniacambogiaslim,http://click2hit.com/puregarciniacambogiaslim,889,890,-1
03:04:2014,puregarciniacambogiaslimsystem,http://click2hit.com/puregarciniacambogiaslimsystem,250,250,0
03:04:2014,puregarciniacanada,http://click2hit.com/puregarciniacanada,54,54,0
03:04:2014,puregarciniaelite,http://click2hit.com/puregarciniaelite,30,31,-1
03:04:2014,puregarciniaslim,http://click2hit.com/puregarciniaslim,341,168,173
03:04:2014,puregarciniaultra,http://click2hit.com/puregarciniaultra,506,512,-6
03:04:2014,puregarciniaultra-1,http://click2hit.com/puregarciniaultra-1,134,134,0
03:04:2014,puregreencoffee,http://click2hit.com/puregreencoffee,419,419,0
03:04:2014,puregreencoffeebeanplus,http://click2hit.com/puregreencoffeebeanplus,1724,1761,-37
03:04:2014,purelifecleanse1,http://click2hit.com/purelifecleanse1,23,90,-67
03:04:2014,purenitrate,http://click2hit.com/purenitrate,49,53,-4
03:04:2014,purenitromax,http://click2hit.com/purenitromax,476,483,-7
03:04:2014,purensa,http://click2hit.com/purensa,1630,1632,-2
03:04:2014,pureraspberryketonepremium,http://click2hit.com/pureraspberryketonepremium,226,226,0
03:04:2014,puressance,http://click2hit.com/puressance,123,124,-1
03:04:2014,purestgarciniacambogia,http://click2hit.com/purestgarciniacambogia,19,19,0
03:04:2014,pureyaconsyrupextract,http://click2hit.com/pureyaconsyrupextract,248,253,-5
03:04:2014,pureyaconsyrupplus,http://click2hit.com/pureyaconsyrupplus,131,140,-9
03:04:2014,pureyaconxt,http://click2hit.com/pureyaconxt,69,69,0
03:04:2014,px800greencoffee,http://click2hit.com/px800greencoffee,54,55,-1
03:04:2014,quickgreencoffee,http://click2hit.com/quickgreencoffee,388,390,-2
03:04:2014,raspberryketonefresh,http://click2hit.com/raspberryketonefresh,1045,1049,-4
03:04:2014,raspberryketoneproslim,http://click2hit.com/raspberryketoneproslim,288,291,-3
03:04:2014,raspberryketones,http://click2hit.com/raspberryketones,297,302,-5
03:04:2014,raspberryslimplus,http://click2hit.com/raspberryslimplus,177,178,-1
03:04:2014,raspberrytones,http://click2hit.com/raspberrytones,357,357,0
03:04:2014,raspberrytrim,http://click2hit.com/raspberrytrim,142,144,-2
03:04:2014,raspberryultraketone,http://click2hit.com/raspberryultraketone,193,194,-1
03:04:2014,rawburn,http://click2hit.com/rawburn,144,144,0
03:04:2014,regularx,http://click2hit.com/regularx,56,61,-5
03:04:2014,rejouvance,http://click2hit.com/rejouvance,475,477,-2
03:04:2014,rejuvaglow,http://click2hit.com/rejuvaglow,65,65,0
03:04:2014,rejuvalash,http://click2hit.com/rejuvalash,246,247,-1
03:04:2014,rejuvalskin,http://click2hit.com/rejuvalskin,1276,1283,-7
03:04:2014,rejuvenex,http://click2hit.com/rejuvenex,349,351,-2
03:04:2014,reliftadvanced,http://click2hit.com/reliftadvanced,264,264,0
03:04:2014,renique,http://click2hit.com/renique,615,623,-8
03:04:2014,restore,http://click2hit.com/restore,77,81,-4
03:04:2014,revitol,http://click2hit.com/revitol,60,60,0
03:04:2014,revivagenix,http://click2hit.com/revivagenix,227,227,0
03:04:2014,revivasol,http://click2hit.com/revivasol,2211,2217,-6
03:04:2014,revolyn,http://click2hit.com/revolyn,213,213,0
03:04:2014,revoreplex,http://click2hit.com/revoreplex,2,203,-201
03:04:2014,rippedmusclex,http://click2hit.com/rippedmusclex,11,12,-1
03:04:2014,rvtl,http://click2hit.com/rvtl,1858,1862,-4
03:04:2014,saphireecig,http://click2hit.com/saphireecig,588,588,0
03:04:2014,secretbodybulk,http://click2hit.com/secretbodybulk,301,303,-2
03:04:2014,secretgarciniacambogia,http://click2hit.com/secretgarciniacambogia,249,249,0
03:04:2014,secretlift,http://click2hit.com/secretlift,264,264,0
03:04:2014,sensa,http://click2hit.com/sensa,129,130,-1
03:04:2014,simplycleanse,http://click2hit.com/simplycleanse,231,232,-1
03:04:2014,simplygarciniacambogia,http://click2hit.com/simplygarciniacambogia,422,424,-2
03:04:2014,simplygreencoffee,http://click2hit.com/simplygreencoffee,319,321,-2
03:04:2014,skinliftadvanced,http://click2hit.com/skinliftadvanced,219,219,0
03:04:2014,skinnyfiber,http://click2hit.com/skinnyfiber,395,396,-1
03:04:2014,slendera-1,http://click2hit.com/slendera-1,39,39,0
03:04:2014,slendera-sab,http://click2hit.com/slendera-sab,66,66,0
03:04:2014,slimberrymax,http://click2hit.com/slimberrymax,247,251,-4
03:04:2014,slimbodycleanse,http://click2hit.com/slimbodycleanse,3071,3078,-7
03:04:2014,slimbodyketones,http://click2hit.com/slimbodyketones,80,86,-6
03:04:2014,slimcleanseplus,http://click2hit.com/slimcleanseplus,106,108,-2
03:04:2014,slimlean,http://click2hit.com/slimlean,1029,1030,-1
03:04:2014,slimnogym,http://click2hit.com/slimnogym,221,222,-1
03:04:2014,slimtrimpm,http://click2hit.com/slimtrimpm,358,367,-9
03:04:2014,smileprodirect,http://click2hit.com/smileprodirect,2807,2843,-36
03:04:2014,solpria,http://click2hit.com/solpria,1076,1077,-1
03:04:2014,sparkwhitening,http://click2hit.com/sparkwhitening,1602,1602,0
03:04:2014,strawberrygarciniacambogia,http://click2hit.com/strawberrygarciniacambogia,413,415,-2
03:04:2014,superbetaprostate,http://click2hit.com/superbetaprostate,151,151,0
03:04:2014,supercoloncleanse1800,http://click2hit.com/supercoloncleanse1800,287,288,-1
03:04:2014,supergarciniacambogia,http://click2hit.com/supergarciniacambogia,941,946,-5
03:04:2014,superiorvelvet,http://click2hit.com/superiorvelvet,401,418,-17
03:04:2014,superketoneplus,http://click2hit.com/superketoneplus,3833,3887,-54
03:04:2014,superlean,http://click2hit.com/superlean,200,200,0
03:04:2014,superleancoloncleanse,http://click2hit.com/superleancoloncleanse,1302,1306,-4
03:04:2014,supertestoboost,http://click2hit.com/supertestoboost,127,128,-1
03:04:2014,superyaconsyrup1000,http://click2hit.com/superyaconsyrup1000,21,22,-1
03:04:2014,supracleanse350,http://click2hit.com/supracleanse350,490,522,-32
03:04:2014,supremeantler,http://click2hit.com/supremeantler,124,126,-2
03:04:2014,svelme,http://click2hit.com/svelme,45,45,0
03:04:2014,swolecreatinemuscle,http://click2hit.com/swolecreatinemuscle,186,186,0
03:04:2014,syneocell,http://click2hit.com/syneocell,188,188,0
03:04:2014,tadvance,http://click2hit.com/tadvance,468,468,0
03:04:2014,testabolancyp,http://click2hit.com/testabolancyp,341,342,-1
03:04:2014,testocoreadvanced,http://click2hit.com/testocoreadvanced,238,246,-8
03:04:2014,testoforceedge,http://click2hit.com/testoforceedge,474,474,0
03:04:2014,testoforcex,http://click2hit.com/testoforcex,293,293,0
03:04:2014,testolimit,http://click2hit.com/testolimit,29,34,-5
03:04:2014,testomax,http://click2hit.com/testomax,274,274,0
03:04:2014,testoril,http://click2hit.com/testoril,519,520,-1
03:04:2014,testorushrx,http://click2hit.com/testorushrx,317,348,-31
03:04:2014,testoupmax,http://click2hit.com/testoupmax,63,65,-2
03:04:2014,testrx360,http://click2hit.com/testrx360,329,331,-2
03:04:2014,testtoforcextreme,http://click2hit.com/testtoforcextreme,382,383,-1
03:04:2014,testx180,http://click2hit.com/testx180,1355,1365,-10
03:04:2014,thermoblackx,http://click2hit.com/thermoblackx,138,138,0
03:04:2014,thermoextreme1,http://click2hit.com/thermoextreme1,567,568,-1
03:04:2014,thermofactorx,http://click2hit.com/thermofactorx,802,807,-5
03:04:2014,thermosculptpro,http://click2hit.com/thermosculptpro,315,317,-2
03:04:2014,titaniumprox,http://click2hit.com/titaniumprox,783,783,0
03:04:2014,tlevelboost,http://click2hit.com/tlevelboost,62,62,0
03:04:2014,tonaderm,http://click2hit.com/tonaderm,185,191,-6
03:04:2014,totalcleansecomplete,http://click2hit.com/totalcleansecomplete,304,321,-17
03:04:2014,trigx2,http://click2hit.com/trigx2,327,328,-1
03:04:2014,trimextrin,http://click2hit.com/trimextrin,170,171,-1
03:04:2014,truburnplus,http://click2hit.com/truburnplus,24,25,-1
03:04:2014,truecleansecomplete,http://click2hit.com/truecleansecomplete,106,116,-10
03:04:2014,turbofrce,http://click2hit.com/turbofrce,413,415,-2
03:04:2014,ultracelebdiet,http://click2hit.com/ultracelebdiet,352,354,-2
03:04:2014,ultracleansepure,http://click2hit.com/ultracleansepure,315,326,-11
03:04:2014,ultracoloncleanse,http://click2hit.com/ultracoloncleanse,38,39,-1
03:04:2014,ultrafinesse,http://click2hit.com/ultrafinesse,71,71,0
03:04:2014,ultragarciniacambogia,http://click2hit.com/ultragarciniacambogia,46,46,0
03:04:2014,ultramaxtestosterone,http://click2hit.com/ultramaxtestosterone,224,226,-2
03:04:2014,ultraslim,http://click2hit.com/ultraslim,187,187,0
03:04:2014,umoris,http://click2hit.com/umoris,392,392,0
03:04:2014,vantage,http://click2hit.com/vantage,518,518,0
03:04:2014,vapexecig,http://click2hit.com/vapexecig,335,337,-2
03:04:2014,vimaxdetox,http://click2hit.com/vimaxdetox,869,873,-4
03:04:2014,virilityex,http://click2hit.com/virilityex,198,201,-3
03:04:2014,vitaberryburn,http://click2hit.com/vitaberryburn,369,369,0
03:04:2014,vitaberrytrim,http://click2hit.com/vitaberrytrim,1786,1795,-9
03:04:2014,vitacleanse,http://click2hit.com/vitacleanse,4317,4373,-56
03:04:2014,vitaketone,http://click2hit.com/vitaketone,903,911,-8
03:04:2014,vitalcleanse,http://click2hit.com/vitalcleanse,181,181,0
03:04:2014,vitalcleansecomplete,http://click2hit.com/vitalcleansecomplete,729,731,-2
03:04:2014,vitalifedetox,http://click2hit.com/vitalifedetox,720,722,-2
03:04:2014,vitalikortest,http://click2hit.com/vitalikortest,590,591,-1
03:04:2014,vitalipo,http://click2hit.com/vitalipo,115,115,0
03:04:2014,vitalitygreencoffee,http://click2hit.com/vitalitygreencoffee,197,197,0
03:04:2014,vitamaxgarciniacambogia,http://click2hit.com/vitamaxgarciniacambogia,1678,1701,-23
03:04:2014,vyalis,http://click2hit.com/vyalis,230,230,0
03:04:2014,wrinklerewind,http://click2hit.com/wrinklerewind,5572,5595,-23
03:04:2014,xmrecovery,http://click2hit.com/xmrecovery,139,139,0
03:04:2014,xtremegarciniacambogia,http://click2hit.com/xtremegarciniacambogia,479,480,-1
03:04:2014,xtremenitro,http://click2hit.com/xtremenitro,1418,1441,-23
03:04:2014,xtremetestosteronebooster,http://click2hit.com/xtremetestosteronebooster,358,360,-2
03:04:2014,yaconmolasses,http://click2hit.com/yaconmolasses,78,78,0
03:04:2014,yaconrootmax,http://click2hit.com/yaconrootmax,809,878,-69
03:04:2014,yaconsyrupdirect,http://click2hit.com/yaconsyrupdirect,212,213,-1
03:04:2014,yolosleep,http://click2hit.com/yolosleep,211,211,0
03:04:2014,youthkitantiaging,http://click2hit.com/youthkitantiaging,187,192,-5
03:04:2014,zenacose,http://click2hit.com/zenacose,160,161,-1
03:04:2014,zenscleanse,http://click2hit.com/zenscleanse,2589,2592,-3
03:04:2014,zinncollection,http://click2hit.com/zinncollection,170,172,-2
03:04:2014,zolyria,http://click2hit.com/zolyria,459,469,-10
03:04:2014,zyloslim,http://click2hit.com/zyloslim,3701,3708,-7
03:04:2014,zymbiotix,http://click2hit.com/zymbiotix,1168,1178,-10
