dt_today,sitetitle,sitelink,pre_click,new_clicks,difrnce
09:04:2014,5stargarciniacambogia,http://click2hit.com/5stargarciniacambogia,87,87,0
09:04:2014,Adrenalast,http://click2hit.com/Adrenalast,548,548,0
09:04:2014,Anataflex,http://click2hit.com/Anataflex,1296,1298,-2
09:04:2014,Diabetix,http://click2hit.com/Diabetix,725,725,0
09:04:2014,Equinox,http://click2hit.com/Equinox,8640,8685,-45
09:04:2014,LuxeCoat,http://click2hit.com/LuxeCoat,413,414,-1
09:04:2014,NOX360,http://click2hit.com/NOX360,53,53,0
09:04:2014,Prescopodene,http://click2hit.com/Prescopodene,1356,1357,-1
09:04:2014,Puregarciniaslim,http://click2hit.com/Puregarciniaslim,173,345,-172
09:04:2014,RevoReplex,http://click2hit.com/RevoReplex,207,4,203
09:04:2014,absoluteraspberryketone,http://click2hit.com/absoluteraspberryketone,9,9,0
09:04:2014,acaiberrypuremax,http://click2hit.com/acaiberrypuremax,174,178,-4
09:04:2014,actionprowhite,http://click2hit.com/actionprowhite,93,137,-44
09:04:2014,activedetoxcleanse,http://click2hit.com/activedetoxcleanse,30,31,-1
09:04:2014,activeraspberryketone,http://click2hit.com/activeraspberryketone,100,112,-12
09:04:2014,advancedgarciniacambogia,http://click2hit.com/advancedgarciniacambogia,778,778,0
09:04:2014,advancedpuregarcinia,http://click2hit.com/advancedpuregarcinia,553,553,0
09:04:2014,advancedtest,http://click2hit.com/advancedtest,571,572,-1
09:04:2014,advancedtrimgreencoffee,http://click2hit.com/advancedtrimgreencoffee,1678,1678,0
09:04:2014,africanmangopremier,http://click2hit.com/africanmangopremier,744,744,0
09:04:2014,agelesshealthsolution,http://click2hit.com/agelesshealthsolution,123,124,-1
09:04:2014,alleureantiagingcream,http://click2hit.com/alleureantiagingcream,240,258,-18
09:04:2014,alleureeyeserum,http://click2hit.com/alleureeyeserum,270,309,-39
09:04:2014,aloeferoxcleanse,http://click2hit.com/aloeferoxcleanse,1323,9,1314
09:04:2014,aloeveracleanse,http://click2hit.com/aloeveracleanse,644,653,-9
09:04:2014,alore,http://click2hit.com/alore,3920,3942,-22
09:04:2014,alphacuthd,http://click2hit.com/alphacuthd,48,53,-5
09:04:2014,alphagenix,http://click2hit.com/alphagenix,57,64,-7
09:04:2014,alphamale,http://click2hit.com/alphamale,197,198,-1
09:04:2014,alphamax1,http://click2hit.com/alphamax1,254,254,0
09:04:2014,amacari,http://click2hit.com/amacari,153,153,0
09:04:2014,amazingcleanse,http://click2hit.com/amazingcleanse,2,2,0
09:04:2014,ambitrimrx,http://click2hit.com/ambitrimrx,772,775,-3
09:04:2014,amino,http://click2hit.com/amino,1270,1271,-1
09:04:2014,andromale,http://click2hit.com/andromale,535,536,-1
09:04:2014,anoradrol,http://click2hit.com/anoradrol,85,85,0
09:04:2014,aussiegarciniacambogia,http://click2hit.com/aussiegarciniacambogia,158,161,-3
09:04:2014,authenticgarciniacambogia,http://click2hit.com/authenticgarciniacambogia,73,73,0
09:04:2014,beaute,http://click2hit.com/beaute,648,648,0
09:04:2014,bellaathome,http://click2hit.com/bellaathome,1760,1763,-3
09:04:2014,bellapure,http://click2hit.com/bellapure,1738,1760,-22
09:04:2014,bellecomplex,http://click2hit.com/bellecomplex,645,649,-4
09:04:2014,berryherbalcleanse,http://click2hit.com/berryherbalcleanse,572,572,0
09:04:2014,berrythingarciniacambogia,http://click2hit.com/berrythingarciniacambogia,540,540,0
09:04:2014,betaalalinemax,http://click2hit.com/betaalalinemax,570,570,0
09:04:2014,betaboost,http://click2hit.com/betaboost,108,108,0
09:04:2014,betaforce,http://click2hit.com/betaforce,655,655,0
09:04:2014,beyondraspberryketone,http://click2hit.com/beyondraspberryketone,2100,2100,0
09:04:2014,biocareslimplus,http://click2hit.com/biocareslimplus,312,313,-1
09:04:2014,biocarexl,http://click2hit.com/biocarexl,327,327,0
09:04:2014,biogeniste,http://click2hit.com/biogeniste,449,449,0
09:04:2014,blackbullmaleenhancement,http://click2hit.com/blackbullmaleenhancement,1457,1457,0
09:04:2014,blackdiamond,http://click2hit.com/blackdiamond,471,500,-29
09:04:2014,blacklineelite,http://click2hit.com/blacklineelite,1506,1530,-24
09:04:2014,blastxl,http://click2hit.com/blastxl,144,144,0
09:04:2014,blizzadwhite,http://click2hit.com/blizzadwhite,22,25,-3
09:04:2014,bluemagicplus,http://click2hit.com/bluemagicplus,870,871,-1
09:04:2014,bodyfuelxs,http://click2hit.com/bodyfuelxs,90,90,0
09:04:2014,brandnew,http://click2hit.com/brandnew,351,351,0
09:04:2014,brandnewbooty,http://click2hit.com/brandnewbooty,770,775,-5
09:04:2014,cafevertextraminceur,http://click2hit.com/cafevertextraminceur,2425,2505,-80
09:04:2014,carbuloss,http://click2hit.com/carbuloss,373,378,-5
09:04:2014,celebritybodynow,http://click2hit.com/celebritybodynow,423,423,0
09:04:2014,celebrityweightlosskit,http://click2hit.com/celebrityweightlosskit,360,360,0
09:04:2014,cellanafricanmango,http://click2hit.com/cellanafricanmango,2160,2246,-86
09:04:2014,cellogicaskin,http://click2hit.com/cellogicaskin,189,191,-2
09:04:2014,cenaless,http://click2hit.com/cenaless,75,75,0
09:04:2014,cenaslim,http://click2hit.com/cenaslim,387,395,-8
09:04:2014,cleandetox,http://click2hit.com/cleandetox,271,273,-2
09:04:2014,cleansecatalystplus,http://click2hit.com/cleansecatalystplus,3333,3342,-9
09:04:2014,cleanseultimo,http://click2hit.com/cleanseultimo,1413,1416,-3
09:04:2014,cocogeniceyeserum,http://click2hit.com/cocogeniceyeserum,10,11,-1
09:04:2014,coffeecleansemax,http://click2hit.com/coffeecleansemax,387,393,-6
09:04:2014,coffeepurecleanse,http://click2hit.com/coffeepurecleanse,54,56,-2
09:04:2014,coleanse,http://click2hit.com/coleanse,2090,2102,-12
09:04:2014,collagen,http://click2hit.com/collagen,19,26,-7
09:04:2014,collagenfaceserum,http://click2hit.com/collagenfaceserum,49,50,-1
09:04:2014,colodetox,http://click2hit.com/colodetox,532,532,0
09:04:2014,colodetoxplus,http://click2hit.com/colodetoxplus,92,92,0
09:04:2014,coloncleanse1300,http://click2hit.com/coloncleanse1300,283,287,-4
09:04:2014,coloncleansecomplete,http://click2hit.com/coloncleansecomplete,1298,1300,-2
09:04:2014,coloncleansetotal,http://click2hit.com/coloncleansetotal,770,770,0
09:04:2014,colondetoxpro,http://click2hit.com/colondetoxpro,39,47,-8
09:04:2014,colonpurecleanse,http://click2hit.com/colonpurecleanse,420,422,-2
09:04:2014,colothin,http://click2hit.com/colothin,192,194,-2
09:04:2014,columbiangreencoffeebean,http://click2hit.com/columbiangreencoffeebean,768,775,-7
09:04:2014,combogiaplus,http://click2hit.com/combogiaplus,331,331,0
09:04:2014,completecoffeecleanse,http://click2hit.com/completecoffeecleanse,400,400,0
09:04:2014,complexiderm,http://click2hit.com/complexiderm,187,187,0
09:04:2014,cosimarevival,http://click2hit.com/cosimarevival,183,184,-1
09:04:2014,cosmitone,http://click2hit.com/cosmitone,1335,1335,0
09:04:2014,csorex,http://click2hit.com/csorex,107,107,0
09:04:2014,curcovia,http://click2hit.com/curcovia,426,426,0
09:04:2014,cutiecurves,http://click2hit.com/cutiecurves,246,246,0
09:04:2014,cytotrim,http://click2hit.com/cytotrim,2,4,-2
09:04:2014,dailyeyerestoration,http://click2hit.com/dailyeyerestoration,150,150,0
09:04:2014,dellure,http://click2hit.com/dellure,118,118,0
09:04:2014,dellurecollagen,http://click2hit.com/dellurecollagen,570,570,0
09:04:2014,dermafirm,http://click2hit.com/dermafirm,761,761,0
09:04:2014,dermajuvenate,http://click2hit.com/dermajuvenate,2339,2353,-14
09:04:2014,dermalift,http://click2hit.com/dermalift,235,235,0
09:04:2014,dermallo,http://click2hit.com/dermallo,269,269,0
09:04:2014,dermalmeds,http://click2hit.com/dermalmeds,446,446,0
09:04:2014,dermangelie,http://click2hit.com/dermangelie,156,156,0
09:04:2014,derminelift,http://click2hit.com/derminelift,404,404,0
09:04:2014,dermology,http://click2hit.com/dermology,42,45,-3
09:04:2014,detoxmax,http://click2hit.com/detoxmax,57,60,-3
09:04:2014,dietultimo,http://click2hit.com/dietultimo,2526,2531,-5
09:04:2014,digestItcoloncleanse,http://click2hit.com/digestItcoloncleanse,63,64,-1
09:04:2014,duplicellp199,http://click2hit.com/duplicellp199,43,45,-2
09:04:2014,duplicellp199facetherapy,http://click2hit.com/duplicellp199facetherapy,46,50,-4
09:04:2014,ecoflex,http://click2hit.com/ecoflex,126,126,0
09:04:2014,electravx,http://click2hit.com/electravx,179,179,0
09:04:2014,elevategf,http://click2hit.com/elevategf,266,269,-3
09:04:2014,elite360,http://click2hit.com/elite360,68,69,-1
09:04:2014,elliskin,http://click2hit.com/elliskin,504,509,-5
09:04:2014,endorev,http://click2hit.com/endorev,463,463,0
09:04:2014,ephedrix,http://click2hit.com/ephedrix,227,228,-1
09:04:2014,equivita,http://click2hit.com/equivita,7837,7893,-56
09:04:2014,essentialdetox,http://click2hit.com/essentialdetox,429,429,0
09:04:2014,extagen,http://click2hit.com/extagen,332,337,-5
09:04:2014,extremefx,http://click2hit.com/extremefx,348,350,-2
09:04:2014,eyeluminous,http://click2hit.com/eyeluminous,634,667,-33
09:04:2014,fembalance,http://click2hit.com/fembalance,362,362,0
09:04:2014,firmativ,http://click2hit.com/firmativ,838,869,-31
09:04:2014,flawlessbeauty,http://click2hit.com/flawlessbeauty,107,108,-1
09:04:2014,flexwell,http://click2hit.com/flexwell,102,103,-1
09:04:2014,forceeffect,http://click2hit.com/forceeffect,283,344,-61
09:04:2014,formularezvmagic,http://click2hit.com/formularezvmagic,231,231,0
09:04:2014,fortdietmax,http://click2hit.com/fortdietmax,82,82,0
09:04:2014,fortmaxdiet,http://click2hit.com/fortmaxdiet,74,74,0
09:04:2014,garciniaberrythin,http://click2hit.com/garciniaberrythin,477,478,-1
09:04:2014,garciniacambogia1300,http://click2hit.com/garciniacambogia1300,661,661,0
09:04:2014,garciniacambogia360,http://click2hit.com/garciniacambogia360,17,19,-2
09:04:2014,garciniacambogia500,http://click2hit.com/garciniacambogia500,3,3,0
09:04:2014,garciniacambogiablast,http://click2hit.com/garciniacambogiablast,750,754,-4
09:04:2014,garciniacambogiaburn,http://click2hit.com/garciniacambogiaburn,97,98,-1
09:04:2014,garciniacambogiacomplex,http://click2hit.com/garciniacambogiacomplex,331,332,-1
09:04:2014,garciniacambogiaextract,http://click2hit.com/garciniacambogiaextract,48,48,0
09:04:2014,garciniacambogiafit1300,http://click2hit.com/garciniacambogiafit1300,129,144,-15
09:04:2014,garciniacambogiaformula,http://click2hit.com/garciniacambogiaformula,36,41,-5
09:04:2014,garciniacambogiahca,http://click2hit.com/garciniacambogiahca,4,4,0
09:04:2014,garciniacambogiaplus,http://click2hit.com/garciniacambogiaplus,1133,1134,-1
09:04:2014,garciniacambogiapro,http://click2hit.com/garciniacambogiapro,18,21,-3
09:04:2014,garciniacambogiaselect,http://click2hit.com/garciniacambogiaselect,489,490,-1
09:04:2014,garciniacambogiaslimfast,http://click2hit.com/garciniacambogiaslimfast,1787,1791,-4
09:04:2014,garciniacambogiaslimsystem,http://click2hit.com/garciniacambogiaslimsystem,1126,1131,-5
09:04:2014,garciniacambogiaxt,http://click2hit.com/garciniacambogiaxt,175,178,-3
09:04:2014,garciniacambogiaz,http://click2hit.com/garciniacambogiaz,2,3,-1
09:04:2014,garciniacombogiasupreme,http://click2hit.com/garciniacombogiasupreme,24,24,0
09:04:2014,garciniadietmax,http://click2hit.com/garciniadietmax,335,339,-4
09:04:2014,garciniaextractplus,http://click2hit.com/garciniaextractplus,232,232,0
09:04:2014,garciniaforte,http://click2hit.com/garciniaforte,4,4,0
09:04:2014,garciniahca,http://click2hit.com/garciniahca,141,141,0
09:04:2014,garciniahcapremium,http://click2hit.com/garciniahcapremium,108,108,0
09:04:2014,garciniaplus,http://click2hit.com/garciniaplus,1980,1986,-6
09:04:2014,garciniasuperdiet,http://click2hit.com/garciniasuperdiet,173,174,-1
09:04:2014,garciniawonder,http://click2hit.com/garciniawonder,814,3,811
09:04:2014,garciniawow,http://click2hit.com/garciniawow,90,95,-5
09:04:2014,garciniaxslim,http://click2hit.com/garciniaxslim,530,553,-23
09:04:2014,gc180xt,http://click2hit.com/gc180xt,559,570,-11
09:04:2014,gcbmaxgreencoffee,http://click2hit.com/gcbmaxgreencoffee,344,344,0
09:04:2014,gcfitsgarcinia,http://click2hit.com/gcfitsgarcinia,6,6,0
09:04:2014,gcxsdiet,http://click2hit.com/gcxsdiet,39,41,-2
09:04:2014,genesis,http://click2hit.com/genesis,43,43,0
09:04:2014,gogiberryburn,http://click2hit.com/gogiberryburn,29,36,-7
09:04:2014,gojiactives,http://click2hit.com/gojiactives,1501,1509,-8
09:04:2014,gojiadvance,http://click2hit.com/gojiadvance,389,392,-3
09:04:2014,gojimax,http://click2hit.com/gojimax,245,250,-5
09:04:2014,gojislim,http://click2hit.com/gojislim,20225,20257,-32
09:04:2014,govapor,http://click2hit.com/govapor,108,111,-3
09:04:2014,greencoffeebeanthin,http://click2hit.com/greencoffeebeanthin,284,287,-3
09:04:2014,greencoffeebody,http://click2hit.com/greencoffeebody,417,417,0
09:04:2014,greencoffeecleanse,http://click2hit.com/greencoffeecleanse,19,19,0
09:04:2014,greencoffeecleanse1,http://click2hit.com/greencoffeecleanse1,28,28,0
09:04:2014,greencoffeecleanses,http://click2hit.com/greencoffeecleanses,837,865,-28
09:04:2014,greencoffeeextraslim,http://click2hit.com/greencoffeeextraslim,272,273,-1
09:04:2014,greencoffeefatburn,http://click2hit.com/greencoffeefatburn,1574,1578,-4
09:04:2014,greencoffeenaxx,http://click2hit.com/greencoffeenaxx,194,194,0
09:04:2014,greencoffeeplus,http://click2hit.com/greencoffeeplus,102,104,-2
09:04:2014,greencoffeeprogram,http://click2hit.com/greencoffeeprogram,59,59,0
09:04:2014,greencoffeerevolution,http://click2hit.com/greencoffeerevolution,25,25,0
09:04:2014,greencoffeespeedslim,http://click2hit.com/greencoffeespeedslim,1417,1443,-26
09:04:2014,greencoffeesupreme,http://click2hit.com/greencoffeesupreme,349,351,-2
09:04:2014,greencoffeesupremecleanse,http://click2hit.com/greencoffeesupremecleanse,120,120,0
09:04:2014,greendetoxpatch,http://click2hit.com/greendetoxpatch,284,284,0
09:04:2014,greenleancoffeebean,http://click2hit.com/greenleancoffeebean,208,209,-1
09:04:2014,greentonepromuscle,http://click2hit.com/greentonepromuscle,214,214,0
09:04:2014,growxl,http://click2hit.com/growxl,2718,2734,-16
09:04:2014,hairgenesis,http://click2hit.com/hairgenesis,79,80,-1
09:04:2014,hardknight,http://click2hit.com/hardknight,1437,1440,-3
09:04:2014,hardknight-1,http://click2hit.com/hardknight-1,84,84,0
09:04:2014,hawaiislim,http://click2hit.com/hawaiislim,145,145,0
09:04:2014,healthycleanse,http://click2hit.com/healthycleanse,514,517,-3
09:04:2014,heboost,http://click2hit.com/heboost,235,235,0
09:04:2014,hghfuel,http://click2hit.com/hghfuel,25,28,-3
09:04:2014,hghpro,http://click2hit.com/hghpro,16,25,-9
09:04:2014,hghxl,http://click2hit.com/hghxl,137,138,-1
09:04:2014,hight,http://click2hit.com/hight,324,324,0
09:04:2014,hspactives,http://click2hit.com/hspactives,2158,2162,-4
09:04:2014,htrush,http://click2hit.com/htrush,305,312,-7
09:04:2014,hydradiance,http://click2hit.com/hydradiance,537,555,-18
09:04:2014,hydrafirm,http://click2hit.com/hydrafirm,259,260,-1
09:04:2014,hydravella,http://click2hit.com/hydravella,227,229,-2
09:04:2014,hydroface,http://click2hit.com/hydroface,619,619,0
09:04:2014,hydroxatone90,http://click2hit.com/hydroxatone90,322,325,-3
09:04:2014,hydroxatonebbcream,http://click2hit.com/hydroxatonebbcream,73,73,0
09:04:2014,idolize,http://click2hit.com/idolize,139,150,-11
09:04:2014,instaleanketones,http://click2hit.com/instaleanketones,695,695,0
09:04:2014,instantderma,http://click2hit.com/instantderma,185,185,0
09:04:2014,instantlift,http://click2hit.com/instantlift,471,471,0
09:04:2014,juvalife,http://click2hit.com/juvalife,89,90,-1
09:04:2014,juvamend,http://click2hit.com/juvamend,3,4,-1
09:04:2014,juvesiio,http://click2hit.com/juvesiio,56,56,0
09:04:2014,ketoneadvanced,http://click2hit.com/ketoneadvanced,2,10,-8
09:04:2014,ketonepremium,http://click2hit.com/ketonepremium,530,530,0
09:04:2014,kollagen,http://click2hit.com/kollagen,81,83,-2
09:04:2014,l-carnitineplus,http://click2hit.com/l-carnitineplus,148,148,0
09:04:2014,ladermanique,http://click2hit.com/ladermanique,1725,1725,0
09:04:2014,larginineplus,http://click2hit.com/larginineplus,30,30,0
09:04:2014,leanmusclex,http://click2hit.com/leanmusclex,8,9,-1
09:04:2014,leptizin,http://click2hit.com/leptizin,104,104,0
09:04:2014,lifecell,http://click2hit.com/lifecell,140,140,0
09:04:2014,liftandglowpro,http://click2hit.com/liftandglowpro,36,36,0
09:04:2014,liftderma,http://click2hit.com/liftderma,764,766,-2
09:04:2014,liftserumpro,http://click2hit.com/liftserumpro,55,55,0
09:04:2014,liftvapor,http://click2hit.com/liftvapor,894,894,0
09:04:2014,lipo13,http://click2hit.com/lipo13,972,1039,-67
09:04:2014,lipog3,http://click2hit.com/lipog3,479,548,-69
09:04:2014,liposlim,http://click2hit.com/liposlim,212,212,0
09:04:2014,lisocleanse,http://click2hit.com/lisocleanse,186,235,-49
09:04:2014,lorelia,http://click2hit.com/lorelia,2133,2147,-14
09:04:2014,lumeraeyeserum,http://click2hit.com/lumeraeyeserum,2257,2266,-9
09:04:2014,luminant,http://click2hit.com/luminant,396,397,-1
09:04:2014,luminantskin,http://click2hit.com/luminantskin,413,413,0
09:04:2014,luminique,http://click2hit.com/luminique,85,85,0
09:04:2014,luministeyegel,http://click2hit.com/luministeyegel,209,210,-1
09:04:2014,lunarsleep,http://click2hit.com/lunarsleep,280,285,-5
09:04:2014,lunathin,http://click2hit.com/lunathin,142,142,0
09:04:2014,lxwpro-t,http://click2hit.com/lxwpro-t,27,31,-4
09:04:2014,lysocleanse,http://click2hit.com/lysocleanse,780,783,-3
09:04:2014,massivevitality,http://click2hit.com/massivevitality,30,30,0
09:04:2014,masspmnight,http://click2hit.com/masspmnight,38,38,0
09:04:2014,maxburncambogia,http://click2hit.com/maxburncambogia,6910,6925,-15
09:04:2014,maxcleanse,http://click2hit.com/maxcleanse,273,273,0
09:04:2014,maxdetox,http://click2hit.com/maxdetox,377,377,0
09:04:2014,maxgarciniaburn,http://click2hit.com/maxgarciniaburn,263,267,-4
09:04:2014,maxleanx,http://click2hit.com/maxleanx,280,281,-1
09:04:2014,maxlight,http://click2hit.com/maxlight,11,11,0
09:04:2014,maxmuscleblast,http://click2hit.com/maxmuscleblast,2,4,-2
09:04:2014,maxmusclelean,http://click2hit.com/maxmusclelean,48,48,0
09:04:2014,maxtrimraspberryketone,http://click2hit.com/maxtrimraspberryketone,107,107,0
09:04:2014,maxxmale,http://click2hit.com/maxxmale,183,183,0
09:04:2014,maxxtest300,http://click2hit.com/maxxtest300,27,28,-1
09:04:2014,miraclegarciniacambogia1300,http://click2hit.com/miraclegarciniacambogia1300,53,53,0
09:04:2014,miraclegarciniacambogiarx,http://click2hit.com/miraclegarciniacambogiarx,68,75,-7
09:04:2014,miraclephytoceramides,http://click2hit.com/miraclephytoceramides,2209,2247,-38
09:04:2014,miracleraspberryketone,http://click2hit.com/miracleraspberryketone,27,29,-2
09:04:2014,mitoslim,http://click2hit.com/mitoslim,749,749,0
09:04:2014,mizulean,http://click2hit.com/mizulean,245,245,0
09:04:2014,musclecorex,http://click2hit.com/musclecorex,514,514,0
09:04:2014,muscleforcex,http://click2hit.com/muscleforcex,89,89,0
09:04:2014,musclekingpro,http://click2hit.com/musclekingpro,303,303,0
09:04:2014,musclemax,http://click2hit.com/musclemax,229,229,0
09:04:2014,muscleripx,http://click2hit.com/muscleripx,215,217,-2
09:04:2014,musclexedge,http://click2hit.com/musclexedge,527,528,-1
09:04:2014,musclexpro,http://click2hit.com/musclexpro,98,99,-1
09:04:2014,musclezx90,http://click2hit.com/musclezx90,2907,2907,0
09:04:2014,naturalburn,http://click2hit.com/naturalburn,258,258,0
09:04:2014,naturalcleanse,http://click2hit.com/naturalcleanse,812,812,0
09:04:2014,naturalcoloncleanseelite,http://click2hit.com/naturalcoloncleanseelite,323,326,-3
09:04:2014,naturaldiet,http://click2hit.com/naturaldiet,147,147,0
09:04:2014,naturalgarciniacambogiaburn,http://click2hit.com/naturalgarciniacambogiaburn,240,241,-1
09:04:2014,naturalgreencleanse,http://click2hit.com/naturalgreencleanse,552,554,-2
09:04:2014,naturalgreencoffeeburn,http://click2hit.com/naturalgreencoffeeburn,423,423,0
09:04:2014,naturalpluscleanse,http://click2hit.com/naturalpluscleanse,130,135,-5
09:04:2014,naturalpurecleanse,http://click2hit.com/naturalpurecleanse,394,394,0
09:04:2014,neucleanseultimate,http://click2hit.com/neucleanseultimate,450,457,-7
09:04:2014,neugarciniacambogia,http://click2hit.com/neugarciniacambogia,18,20,-2
09:04:2014,neuropathysupportformula,http://click2hit.com/neuropathysupportformula,253,257,-4
09:04:2014,newagecleanse,http://click2hit.com/newagecleanse,330,333,-3
09:04:2014,newlifecleanse,http://click2hit.com/newlifecleanse,158,160,-2
09:04:2014,nidora,http://click2hit.com/nidora,562,599,-37
09:04:2014,nitricmaxmuscle,http://click2hit.com/nitricmaxmuscle,321,325,-4
09:04:2014,nitricmaxmuscle1,http://click2hit.com/nitricmaxmuscle1,62,62,0
09:04:2014,nitricpower,http://click2hit.com/nitricpower,14,14,0
09:04:2014,nitroxin,http://click2hit.com/nitroxin,37,40,-3
09:04:2014,nitroxl,http://click2hit.com/nitroxl,282,282,0
09:04:2014,nitroxpro,http://click2hit.com/nitroxpro,6693,6830,-137
09:04:2014,no2explodeextreme,http://click2hit.com/no2explodeextreme,1504,1513,-9
09:04:2014,no2factor,http://click2hit.com/no2factor,330,330,0
09:04:2014,no2maximus,http://click2hit.com/no2maximus,2416,2452,-36
09:04:2014,no2surge,http://click2hit.com/no2surge,287,324,-37
09:04:2014,nuetrim,http://click2hit.com/nuetrim,429,429,0
09:04:2014,nutraburn10,http://click2hit.com/nutraburn10,97,97,0
09:04:2014,nutranaturalgarciniacambogia,http://click2hit.com/nutranaturalgarciniacambogia,118,118,0
09:04:2014,nutridiet,http://click2hit.com/nutridiet,1049,1082,-33
09:04:2014,nuvagenic,http://click2hit.com/nuvagenic,197,197,0
09:04:2014,nuvie,http://click2hit.com/nuvie,168,172,-4
09:04:2014,nuvocleanse,http://click2hit.com/nuvocleanse,591,591,0
09:04:2014,nuvoslim,http://click2hit.com/nuvoslim,435,460,-25
09:04:2014,onemoment,http://click2hit.com/onemoment,162,175,-13
09:04:2014,optimalstack,http://click2hit.com/optimalstack,468,493,-25
09:04:2014,organiccleanse,http://click2hit.com/organiccleanse,3,3,0
09:04:2014,organiccleansedetox,http://click2hit.com/organiccleansedetox,67,69,-2
09:04:2014,organicgarciniacambogia,http://click2hit.com/organicgarciniacambogia,195,195,0
09:04:2014,originalgarciniacambogia,http://click2hit.com/originalgarciniacambogia,55,60,-5
09:04:2014,originalyaconextract,http://click2hit.com/originalyaconextract,154,154,0
09:04:2014,originalyaconsyrup,http://click2hit.com/originalyaconsyrup,57,57,0
09:04:2014,orvigomax,http://click2hit.com/orvigomax,77,81,-4
09:04:2014,ourgreencleanse,http://click2hit.com/ourgreencleanse,147,149,-2
09:04:2014,oxygenius,http://click2hit.com/oxygenius,1371,1399,-28
09:04:2014,pelevoni,http://click2hit.com/pelevoni,320,322,-2
09:04:2014,platinumgarciniacambogia,http://click2hit.com/platinumgarciniacambogia,368,372,-4
09:04:2014,poshcream,http://click2hit.com/poshcream,47,48,-1
09:04:2014,powermax,http://click2hit.com/powermax,11,12,-1
09:04:2014,powerprecision,http://click2hit.com/powerprecision,120,121,-1
09:04:2014,poweruphealthgarcinia,http://click2hit.com/poweruphealthgarcinia,158,179,-21
09:04:2014,premiermangocleanse,http://click2hit.com/premiermangocleanse,204,204,0
09:04:2014,premiumgarciniacambogiaslim,http://click2hit.com/premiumgarciniacambogiaslim,137,158,-21
09:04:2014,premiumgreencoffeebean,http://click2hit.com/premiumgreencoffeebean,208,208,0
09:04:2014,procollagen,http://click2hit.com/procollagen,267,267,0
09:04:2014,procoloncleanse,http://click2hit.com/procoloncleanse,168,168,0
09:04:2014,prodermagenix,http://click2hit.com/prodermagenix,188,188,0
09:04:2014,prodermagenixplus,http://click2hit.com/prodermagenixplus,257,257,0
09:04:2014,progain350,http://click2hit.com/progain350,3,3,0
09:04:2014,prolong,http://click2hit.com/prolong,659,710,-51
09:04:2014,prolongz,http://click2hit.com/prolongz,463,489,-26
09:04:2014,promusclecomplex,http://click2hit.com/promusclecomplex,541,542,-1
09:04:2014,pronutragarcinia,http://click2hit.com/pronutragarcinia,55,57,-2
09:04:2014,protrim,http://click2hit.com/protrim,1048,1048,0
09:04:2014,purafit,http://click2hit.com/purafit,368,368,0
09:04:2014,puragreencoffee,http://click2hit.com/puragreencoffee,288,290,-2
09:04:2014,pureberrymax,http://click2hit.com/pureberrymax,269,269,0
09:04:2014,purebiodiet,http://click2hit.com/purebiodiet,650,658,-8
09:04:2014,purecambogiaultra,http://click2hit.com/purecambogiaultra,211,216,-5
09:04:2014,purecambogiaultra-1,http://click2hit.com/purecambogiaultra-1,598,602,-4
09:04:2014,purecambogiaultra2,http://click2hit.com/purecambogiaultra2,178,179,-1
09:04:2014,purecleanse,http://click2hit.com/purecleanse,500,501,-1
09:04:2014,purecleansemax,http://click2hit.com/purecleansemax,4,4,0
09:04:2014,purecolocleanse,http://click2hit.com/purecolocleanse,267,268,-1
09:04:2014,purecoloncleanser,http://click2hit.com/purecoloncleanser,1555,1555,0
09:04:2014,puregarciniacambogia,http://click2hit.com/puregarciniacambogia,195,195,0
09:04:2014,puregarciniacambogia-1,http://click2hit.com/puregarciniacambogia-1,7792,7894,-102
09:04:2014,puregarciniacambogiaburn,http://click2hit.com/puregarciniacambogiaburn,2329,2332,-3
09:04:2014,puregarciniacambogiaplus,http://click2hit.com/puregarciniacambogiaplus,377,379,-2
09:04:2014,puregarciniacambogiapremium,http://click2hit.com/puregarciniacambogiapremium,1233,1247,-14
09:04:2014,puregarciniacambogiaslim,http://click2hit.com/puregarciniacambogiaslim,893,893,0
09:04:2014,puregarciniacambogiaslimsystem,http://click2hit.com/puregarciniacambogiaslimsystem,252,253,-1
09:04:2014,puregarciniacanada,http://click2hit.com/puregarciniacanada,56,57,-1
09:04:2014,puregarciniaelite,http://click2hit.com/puregarciniaelite,31,32,-1
09:04:2014,puregarciniaslim,http://click2hit.com/puregarciniaslim,345,173,172
09:04:2014,puregarciniaultra,http://click2hit.com/puregarciniaultra,533,535,-2
09:04:2014,puregarciniaultra-1,http://click2hit.com/puregarciniaultra-1,134,134,0
09:04:2014,puregreencoffee,http://click2hit.com/puregreencoffee,420,420,0
09:04:2014,puregreencoffeebeanplus,http://click2hit.com/puregreencoffeebeanplus,27,34,-7
09:04:2014,purelifecleanse1,http://click2hit.com/purelifecleanse1,480,552,-72
09:04:2014,purenitrate,http://click2hit.com/purenitrate,94,94,0
09:04:2014,purenitromax,http://click2hit.com/purenitromax,491,495,-4
09:04:2014,purensa,http://click2hit.com/purensa,1666,1671,-5
09:04:2014,pureraspberryketonepremium,http://click2hit.com/pureraspberryketonepremium,239,239,0
09:04:2014,puressance,http://click2hit.com/puressance,124,124,0
09:04:2014,purestgarciniacambogia,http://click2hit.com/purestgarciniacambogia,19,20,-1
09:04:2014,pureyaconsyrupextract,http://click2hit.com/pureyaconsyrupextract,255,257,-2
09:04:2014,pureyaconsyrupplus,http://click2hit.com/pureyaconsyrupplus,149,150,-1
09:04:2014,pureyaconxt,http://click2hit.com/pureyaconxt,75,75,0
09:04:2014,px800greencoffee,http://click2hit.com/px800greencoffee,57,58,-1
09:04:2014,quickgreencoffee,http://click2hit.com/quickgreencoffee,396,396,0
09:04:2014,raspberryketonefresh,http://click2hit.com/raspberryketonefresh,1066,1070,-4
09:04:2014,raspberryketoneproslim,http://click2hit.com/raspberryketoneproslim,313,317,-4
09:04:2014,raspberryketones,http://click2hit.com/raspberryketones,323,330,-7
09:04:2014,raspberryslimplus,http://click2hit.com/raspberryslimplus,178,178,0
09:04:2014,raspberrytones,http://click2hit.com/raspberrytones,359,364,-5
09:04:2014,raspberrytrim,http://click2hit.com/raspberrytrim,154,155,-1
09:04:2014,raspberryultraketone,http://click2hit.com/raspberryultraketone,200,201,-1
09:04:2014,rawburn,http://click2hit.com/rawburn,145,145,0
09:04:2014,regularx,http://click2hit.com/regularx,115,121,-6
09:04:2014,rejouvance,http://click2hit.com/rejouvance,482,483,-1
09:04:2014,rejuvaglow,http://click2hit.com/rejuvaglow,65,66,-1
09:04:2014,rejuvalash,http://click2hit.com/rejuvalash,256,256,0
09:04:2014,rejuvalskin,http://click2hit.com/rejuvalskin,34,48,-14
09:04:2014,rejuvenex,http://click2hit.com/rejuvenex,352,352,0
09:04:2014,reliftadvanced,http://click2hit.com/reliftadvanced,269,269,0
09:04:2014,renique,http://click2hit.com/renique,674,682,-8
09:04:2014,restore,http://click2hit.com/restore,85,85,0
09:04:2014,revitol,http://click2hit.com/revitol,63,65,-2
09:04:2014,revivagenix,http://click2hit.com/revivagenix,227,228,-1
09:04:2014,revivasol,http://click2hit.com/revivasol,2240,2242,-2
09:04:2014,revolyn,http://click2hit.com/revolyn,213,213,0
09:04:2014,revoreplex,http://click2hit.com/revoreplex,4,207,-203
09:04:2014,rippedmusclex,http://click2hit.com/rippedmusclex,12,12,0
09:04:2014,rvtl,http://click2hit.com/rvtl,1900,1901,-1
09:04:2014,saphireecig,http://click2hit.com/saphireecig,592,592,0
09:04:2014,secretbodybulk,http://click2hit.com/secretbodybulk,307,308,-1
09:04:2014,secretgarciniacambogia,http://click2hit.com/secretgarciniacambogia,249,249,0
09:04:2014,secretlift,http://click2hit.com/secretlift,10,10,0
09:04:2014,sensa,http://click2hit.com/sensa,132,132,0
09:04:2014,simplycleanse,http://click2hit.com/simplycleanse,235,235,0
09:04:2014,simplygarciniacambogia,http://click2hit.com/simplygarciniacambogia,433,434,-1
09:04:2014,simplygreencoffee,http://click2hit.com/simplygreencoffee,330,330,0
09:04:2014,skinliftadvanced,http://click2hit.com/skinliftadvanced,222,222,0
09:04:2014,skinnyfiber,http://click2hit.com/skinnyfiber,397,397,0
09:04:2014,slendera-1,http://click2hit.com/slendera-1,39,39,0
09:04:2014,slendera-sab,http://click2hit.com/slendera-sab,70,70,0
09:04:2014,slimberrymax,http://click2hit.com/slimberrymax,258,258,0
09:04:2014,slimbodycleanse,http://click2hit.com/slimbodycleanse,3110,3110,0
09:04:2014,slimbodyketones,http://click2hit.com/slimbodyketones,134,138,-4
09:04:2014,slimcleanseplus,http://click2hit.com/slimcleanseplus,110,110,0
09:04:2014,slimlean,http://click2hit.com/slimlean,1035,1036,-1
09:04:2014,slimnogym,http://click2hit.com/slimnogym,223,223,0
09:04:2014,slimtrimpm,http://click2hit.com/slimtrimpm,48,71,-23
09:04:2014,smileprodirect,http://click2hit.com/smileprodirect,2930,2979,-49
09:04:2014,solpria,http://click2hit.com/solpria,1084,1085,-1
09:04:2014,sparkwhitening,http://click2hit.com/sparkwhitening,1603,1603,0
09:04:2014,strawberrygarciniacambogia,http://click2hit.com/strawberrygarciniacambogia,441,450,-9
09:04:2014,superbetaprostate,http://click2hit.com/superbetaprostate,152,152,0
09:04:2014,supercoloncleanse1800,http://click2hit.com/supercoloncleanse1800,289,289,0
09:04:2014,supergarciniacambogia,http://click2hit.com/supergarciniacambogia,983,990,-7
09:04:2014,superiorvelvet,http://click2hit.com/superiorvelvet,473,480,-7
09:04:2014,superketoneplus,http://click2hit.com/superketoneplus,4052,4070,-18
09:04:2014,superlean,http://click2hit.com/superlean,200,201,-1
09:04:2014,superleancoloncleanse,http://click2hit.com/superleancoloncleanse,1338,1341,-3
09:04:2014,supertestoboost,http://click2hit.com/supertestoboost,133,133,0
09:04:2014,superyaconsyrup1000,http://click2hit.com/superyaconsyrup1000,24,24,0
09:04:2014,supracleanse350,http://click2hit.com/supracleanse350,665,749,-84
09:04:2014,supremeantler,http://click2hit.com/supremeantler,130,134,-4
09:04:2014,svelme,http://click2hit.com/svelme,46,46,0
09:04:2014,swolecreatinemuscle,http://click2hit.com/swolecreatinemuscle,186,186,0
09:04:2014,syneocell,http://click2hit.com/syneocell,188,188,0
09:04:2014,tadvance,http://click2hit.com/tadvance,470,470,0
09:04:2014,testabolancyp,http://click2hit.com/testabolancyp,343,343,0
09:04:2014,testocoreadvanced,http://click2hit.com/testocoreadvanced,296,305,-9
09:04:2014,testoforceedge,http://click2hit.com/testoforceedge,478,478,0
09:04:2014,testoforcex,http://click2hit.com/testoforcex,294,294,0
09:04:2014,testolimit,http://click2hit.com/testolimit,39,40,-1
09:04:2014,testomax,http://click2hit.com/testomax,275,276,-1
09:04:2014,testoril,http://click2hit.com/testoril,522,522,0
09:04:2014,testorushrx,http://click2hit.com/testorushrx,413,425,-12
09:04:2014,testoupmax,http://click2hit.com/testoupmax,105,111,-6
09:04:2014,testrx360,http://click2hit.com/testrx360,333,333,0
09:04:2014,testtoforcextreme,http://click2hit.com/testtoforcextreme,387,387,0
09:04:2014,testx180,http://click2hit.com/testx180,1408,1416,-8
09:04:2014,thermoblackx,http://click2hit.com/thermoblackx,141,141,0
09:04:2014,thermoextreme1,http://click2hit.com/thermoextreme1,570,570,0
09:04:2014,thermofactorx,http://click2hit.com/thermofactorx,817,819,-2
09:04:2014,thermosculptpro,http://click2hit.com/thermosculptpro,322,323,-1
09:04:2014,titaniumprox,http://click2hit.com/titaniumprox,791,794,-3
09:04:2014,tlevelboost,http://click2hit.com/tlevelboost,64,65,-1
09:04:2014,tonaderm,http://click2hit.com/tonaderm,202,203,-1
09:04:2014,totalcleansecomplete,http://click2hit.com/totalcleansecomplete,377,386,-9
09:04:2014,trigx2,http://click2hit.com/trigx2,330,330,0
09:04:2014,trimextrin,http://click2hit.com/trimextrin,0,0,0
09:04:2014,truburnplus,http://click2hit.com/truburnplus,27,33,-6
09:04:2014,truecleansecomplete,http://click2hit.com/truecleansecomplete,193,211,-18
09:04:2014,turbofrce,http://click2hit.com/turbofrce,422,423,-1
09:04:2014,ultracelebdiet,http://click2hit.com/ultracelebdiet,361,361,0
09:04:2014,ultracleansepure,http://click2hit.com/ultracleansepure,418,2,416
09:04:2014,ultracoloncleanse,http://click2hit.com/ultracoloncleanse,44,44,0
09:04:2014,ultrafinesse,http://click2hit.com/ultrafinesse,84,84,0
09:04:2014,ultragarciniacambogia,http://click2hit.com/ultragarciniacambogia,52,52,0
09:04:2014,ultramaxtestosterone,http://click2hit.com/ultramaxtestosterone,227,228,-1
09:04:2014,ultraslim,http://click2hit.com/ultraslim,189,189,0
09:04:2014,umoris,http://click2hit.com/umoris,404,409,-5
09:04:2014,vantage,http://click2hit.com/vantage,5,5,0
09:04:2014,vapexecig,http://click2hit.com/vapexecig,342,342,0
09:04:2014,vimaxdetox,http://click2hit.com/vimaxdetox,885,886,-1
09:04:2014,virilityex,http://click2hit.com/virilityex,202,202,0
09:04:2014,vitaberryburn,http://click2hit.com/vitaberryburn,371,371,0
09:04:2014,vitaberrytrim,http://click2hit.com/vitaberrytrim,1804,1806,-2
09:04:2014,vitacleanse,http://click2hit.com/vitacleanse,4518,4560,-42
09:04:2014,vitaketone,http://click2hit.com/vitaketone,944,948,-4
09:04:2014,vitalcleanse,http://click2hit.com/vitalcleanse,181,181,0
09:04:2014,vitalcleansecomplete,http://click2hit.com/vitalcleansecomplete,754,761,-7
09:04:2014,vitalifedetox,http://click2hit.com/vitalifedetox,742,742,0
09:04:2014,vitalikortest,http://click2hit.com/vitalikortest,599,599,0
09:04:2014,vitalipo,http://click2hit.com/vitalipo,122,122,0
09:04:2014,vitalitygreencoffee,http://click2hit.com/vitalitygreencoffee,197,197,0
09:04:2014,vitamaxgarciniacambogia,http://click2hit.com/vitamaxgarciniacambogia,1783,1807,-24
09:04:2014,vyalis,http://click2hit.com/vyalis,232,234,-2
09:04:2014,wrinklerewind,http://click2hit.com/wrinklerewind,5716,5751,-35
09:04:2014,xmrecovery,http://click2hit.com/xmrecovery,147,148,-1
09:04:2014,xtremegarciniacambogia,http://click2hit.com/xtremegarciniacambogia,484,484,0
09:04:2014,xtremenitro,http://click2hit.com/xtremenitro,32,46,-14
09:04:2014,xtremetestosteronebooster,http://click2hit.com/xtremetestosteronebooster,364,365,-1
09:04:2014,yaconmolasses,http://click2hit.com/yaconmolasses,80,81,-1
09:04:2014,yaconrootmax,http://click2hit.com/yaconrootmax,1179,1256,-77
09:04:2014,yaconsyrupdirect,http://click2hit.com/yaconsyrupdirect,215,218,-3
09:04:2014,yolosleep,http://click2hit.com/yolosleep,213,213,0
09:04:2014,youthkitantiaging,http://click2hit.com/youthkitantiaging,198,199,-1
09:04:2014,zenacose,http://click2hit.com/zenacose,163,163,0
09:04:2014,zenscleanse,http://click2hit.com/zenscleanse,2613,2618,-5
09:04:2014,zinncollection,http://click2hit.com/zinncollection,180,180,0
09:04:2014,zolyria,http://click2hit.com/zolyria,491,498,-7
09:04:2014,zyloslim,http://click2hit.com/zyloslim,3756,3764,-8
09:04:2014,zymbiotix,http://click2hit.com/zymbiotix,1267,1280,-13
