dt_today,sitetitle,sitelink,pre_click,new_clicks,difrnce
05:04:2014,5stargarciniacambogia,http://click2hit.com/5stargarciniacambogia,84,85,-1
05:04:2014,Adrenalast,http://click2hit.com/Adrenalast,546,546,0
05:04:2014,Anataflex,http://click2hit.com/Anataflex,1287,1292,-5
05:04:2014,Diabetix,http://click2hit.com/Diabetix,724,725,-1
05:04:2014,Equinox,http://click2hit.com/Equinox,8527,8562,-35
05:04:2014,LuxeCoat,http://click2hit.com/LuxeCoat,409,410,-1
05:04:2014,NOX360,http://click2hit.com/NOX360,50,50,0
05:04:2014,Prescopodene,http://click2hit.com/Prescopodene,1348,1351,-3
05:04:2014,Puregarciniaslim,http://click2hit.com/Puregarciniaslim,168,343,-175
05:04:2014,RevoReplex,http://click2hit.com/RevoReplex,206,3,203
05:04:2014,absoluteraspberryketone,http://click2hit.com/absoluteraspberryketone,2,7,-5
05:04:2014,acaiberrypuremax,http://click2hit.com/acaiberrypuremax,169,170,-1
05:04:2014,actionprowhite,http://click2hit.com/actionprowhite,13,35,-22
05:04:2014,activedetoxcleanse,http://click2hit.com/activedetoxcleanse,16,19,-3
05:04:2014,activeraspberryketone,http://click2hit.com/activeraspberryketone,23,47,-24
05:04:2014,advancedgarciniacambogia,http://click2hit.com/advancedgarciniacambogia,778,778,0
05:04:2014,advancedpuregarcinia,http://click2hit.com/advancedpuregarcinia,552,552,0
05:04:2014,advancedtest,http://click2hit.com/advancedtest,568,568,0
05:04:2014,advancedtrimgreencoffee,http://click2hit.com/advancedtrimgreencoffee,1672,1672,0
05:04:2014,africanmangopremier,http://click2hit.com/africanmangopremier,742,742,0
05:04:2014,agelesshealthsolution,http://click2hit.com/agelesshealthsolution,120,120,0
05:04:2014,alleureantiagingcream,http://click2hit.com/alleureantiagingcream,87,127,-40
05:04:2014,alleureeyeserum,http://click2hit.com/alleureeyeserum,84,129,-45
05:04:2014,aloeferoxcleanse,http://click2hit.com/aloeferoxcleanse,1276,1291,-15
05:04:2014,aloeveracleanse,http://click2hit.com/aloeveracleanse,634,639,-5
05:04:2014,alore,http://click2hit.com/alore,3858,3871,-13
05:04:2014,alphacuthd,http://click2hit.com/alphacuthd,39,40,-1
05:04:2014,alphagenix,http://click2hit.com/alphagenix,19,25,-6
05:04:2014,alphamale,http://click2hit.com/alphamale,197,197,0
05:04:2014,alphamax1,http://click2hit.com/alphamax1,250,250,0
05:04:2014,amacari,http://click2hit.com/amacari,152,152,0
05:04:2014,amazingcleanse,http://click2hit.com/amazingcleanse,2,2,0
05:04:2014,ambitrimrx,http://click2hit.com/ambitrimrx,772,772,0
05:04:2014,amino,http://click2hit.com/amino,1269,1269,0
05:04:2014,andromale,http://click2hit.com/andromale,532,532,0
05:04:2014,anoradrol,http://click2hit.com/anoradrol,85,85,0
05:04:2014,aussiegarciniacambogia,http://click2hit.com/aussiegarciniacambogia,157,157,0
05:04:2014,authenticgarciniacambogia,http://click2hit.com/authenticgarciniacambogia,67,68,-1
05:04:2014,beaute,http://click2hit.com/beaute,645,645,0
05:04:2014,bellaathome,http://click2hit.com/bellaathome,1755,1757,-2
05:04:2014,bellapure,http://click2hit.com/bellapure,1671,1698,-27
05:04:2014,bellecomplex,http://click2hit.com/bellecomplex,638,639,-1
05:04:2014,berryherbalcleanse,http://click2hit.com/berryherbalcleanse,570,571,-1
05:04:2014,berrythingarciniacambogia,http://click2hit.com/berrythingarciniacambogia,540,540,0
05:04:2014,betaalalinemax,http://click2hit.com/betaalalinemax,568,570,-2
05:04:2014,betaboost,http://click2hit.com/betaboost,107,108,-1
05:04:2014,betaforce,http://click2hit.com/betaforce,654,654,0
05:04:2014,beyondraspberryketone,http://click2hit.com/beyondraspberryketone,2098,2098,0
05:04:2014,biocareslimplus,http://click2hit.com/biocareslimplus,312,312,0
05:04:2014,biocarexl,http://click2hit.com/biocarexl,326,326,0
05:04:2014,biogeniste,http://click2hit.com/biogeniste,447,448,-1
05:04:2014,blackbullmaleenhancement,http://click2hit.com/blackbullmaleenhancement,1450,1452,-2
05:04:2014,blackdiamond,http://click2hit.com/blackdiamond,398,420,-22
05:04:2014,blacklineelite,http://click2hit.com/blacklineelite,1388,1412,-24
05:04:2014,blastxl,http://click2hit.com/blastxl,142,142,0
05:04:2014,blizzadwhite,http://click2hit.com/blizzadwhite,9,15,-6
05:04:2014,bluemagicplus,http://click2hit.com/bluemagicplus,863,865,-2
05:04:2014,bodyfuelxs,http://click2hit.com/bodyfuelxs,89,89,0
05:04:2014,brandnew,http://click2hit.com/brandnew,350,351,-1
05:04:2014,brandnewbooty,http://click2hit.com/brandnewbooty,766,766,0
05:04:2014,cafevertextraminceur,http://click2hit.com/cafevertextraminceur,2008,2100,-92
05:04:2014,carbuloss,http://click2hit.com/carbuloss,342,351,-9
05:04:2014,celebritybodynow,http://click2hit.com/celebritybodynow,418,419,-1
05:04:2014,celebrityweightlosskit,http://click2hit.com/celebrityweightlosskit,359,359,0
05:04:2014,cellanafricanmango,http://click2hit.com/cellanafricanmango,1735,1881,-146
05:04:2014,cellogicaskin,http://click2hit.com/cellogicaskin,173,175,-2
05:04:2014,cenaless,http://click2hit.com/cenaless,75,75,0
05:04:2014,cenaslim,http://click2hit.com/cenaslim,385,385,0
05:04:2014,cleandetox,http://click2hit.com/cleandetox,269,270,-1
05:04:2014,cleansecatalystplus,http://click2hit.com/cleansecatalystplus,3289,3296,-7
05:04:2014,cleanseultimo,http://click2hit.com/cleanseultimo,1400,1404,-4
05:04:2014,cocogeniceyeserum,http://click2hit.com/cocogeniceyeserum,5,6,-1
05:04:2014,coffeecleansemax,http://click2hit.com/coffeecleansemax,381,383,-2
05:04:2014,coffeepurecleanse,http://click2hit.com/coffeepurecleanse,43,49,-6
05:04:2014,coleanse,http://click2hit.com/coleanse,2049,2059,-10
05:04:2014,collagen,http://click2hit.com/collagen,5,11,-6
05:04:2014,collagenfaceserum,http://click2hit.com/collagenfaceserum,45,45,0
05:04:2014,colodetox,http://click2hit.com/colodetox,530,530,0
05:04:2014,colodetoxplus,http://click2hit.com/colodetoxplus,92,92,0
05:04:2014,coloncleanse1300,http://click2hit.com/coloncleanse1300,280,282,-2
05:04:2014,coloncleansecomplete,http://click2hit.com/coloncleansecomplete,1279,1282,-3
05:04:2014,coloncleansetotal,http://click2hit.com/coloncleansetotal,765,766,-1
05:04:2014,colondetoxpro,http://click2hit.com/colondetoxpro,23,27,-4
05:04:2014,colonpurecleanse,http://click2hit.com/colonpurecleanse,408,413,-5
05:04:2014,colothin,http://click2hit.com/colothin,189,189,0
05:04:2014,columbiangreencoffeebean,http://click2hit.com/columbiangreencoffeebean,721,726,-5
05:04:2014,combogiaplus,http://click2hit.com/combogiaplus,329,329,0
05:04:2014,completecoffeecleanse,http://click2hit.com/completecoffeecleanse,394,394,0
05:04:2014,complexiderm,http://click2hit.com/complexiderm,187,187,0
05:04:2014,cosimarevival,http://click2hit.com/cosimarevival,182,182,0
05:04:2014,cosmitone,http://click2hit.com/cosmitone,1330,1331,-1
05:04:2014,csorex,http://click2hit.com/csorex,106,107,-1
05:04:2014,curcovia,http://click2hit.com/curcovia,424,424,0
05:04:2014,cutiecurves,http://click2hit.com/cutiecurves,246,246,0
05:04:2014,cytotrim,http://click2hit.com/cytotrim,0,2,-2
05:04:2014,dailyeyerestoration,http://click2hit.com/dailyeyerestoration,135,141,-6
05:04:2014,dellure,http://click2hit.com/dellure,114,116,-2
05:04:2014,dellurecollagen,http://click2hit.com/dellurecollagen,568,569,-1
05:04:2014,dermafirm,http://click2hit.com/dermafirm,758,758,0
05:04:2014,dermajuvenate,http://click2hit.com/dermajuvenate,2291,2300,-9
05:04:2014,dermalift,http://click2hit.com/dermalift,235,235,0
05:04:2014,dermallo,http://click2hit.com/dermallo,268,269,-1
05:04:2014,dermalmeds,http://click2hit.com/dermalmeds,444,444,0
05:04:2014,dermangelie,http://click2hit.com/dermangelie,151,154,-3
05:04:2014,derminelift,http://click2hit.com/derminelift,402,403,-1
05:04:2014,dermology,http://click2hit.com/dermology,40,42,-2
05:04:2014,detoxmax,http://click2hit.com/detoxmax,50,52,-2
05:04:2014,dietultimo,http://click2hit.com/dietultimo,2487,2500,-13
05:04:2014,digestItcoloncleanse,http://click2hit.com/digestItcoloncleanse,59,60,-1
05:04:2014,duplicellp199,http://click2hit.com/duplicellp199,32,32,0
05:04:2014,duplicellp199facetherapy,http://click2hit.com/duplicellp199facetherapy,30,33,-3
05:04:2014,ecoflex,http://click2hit.com/ecoflex,124,126,-2
05:04:2014,electravx,http://click2hit.com/electravx,178,179,-1
05:04:2014,elevategf,http://click2hit.com/elevategf,265,265,0
05:04:2014,elite360,http://click2hit.com/elite360,67,68,-1
05:04:2014,elliskin,http://click2hit.com/elliskin,498,500,-2
05:04:2014,endorev,http://click2hit.com/endorev,459,459,0
05:04:2014,ephedrix,http://click2hit.com/ephedrix,226,227,-1
05:04:2014,equivita,http://click2hit.com/equivita,7671,7713,-42
05:04:2014,essentialdetox,http://click2hit.com/essentialdetox,426,427,-1
05:04:2014,extagen,http://click2hit.com/extagen,314,315,-1
05:04:2014,extremefx,http://click2hit.com/extremefx,339,340,-1
05:04:2014,eyeluminous,http://click2hit.com/eyeluminous,558,567,-9
05:04:2014,fembalance,http://click2hit.com/fembalance,360,361,-1
05:04:2014,firmativ,http://click2hit.com/firmativ,729,743,-14
05:04:2014,flawlessbeauty,http://click2hit.com/flawlessbeauty,94,97,-3
05:04:2014,flexwell,http://click2hit.com/flexwell,102,102,0
05:04:2014,forceeffect,http://click2hit.com/forceeffect,92,143,-51
05:04:2014,formularezvmagic,http://click2hit.com/formularezvmagic,231,231,0
05:04:2014,fortdietmax,http://click2hit.com/fortdietmax,79,79,0
05:04:2014,fortmaxdiet,http://click2hit.com/fortmaxdiet,72,72,0
05:04:2014,garciniaberrythin,http://click2hit.com/garciniaberrythin,477,477,0
05:04:2014,garciniacambogia1300,http://click2hit.com/garciniacambogia1300,653,658,-5
05:04:2014,garciniacambogia360,http://click2hit.com/garciniacambogia360,11,12,-1
05:04:2014,garciniacambogia500,http://click2hit.com/garciniacambogia500,2,2,0
05:04:2014,garciniacambogiablast,http://click2hit.com/garciniacambogiablast,716,724,-8
05:04:2014,garciniacambogiaburn,http://click2hit.com/garciniacambogiaburn,92,93,-1
05:04:2014,garciniacambogiacomplex,http://click2hit.com/garciniacambogiacomplex,326,327,-1
05:04:2014,garciniacambogiaextract,http://click2hit.com/garciniacambogiaextract,47,47,0
05:04:2014,garciniacambogiafit1300,http://click2hit.com/garciniacambogiafit1300,124,126,-2
05:04:2014,garciniacambogiaformula,http://click2hit.com/garciniacambogiaformula,27,28,-1
05:04:2014,garciniacambogiahca,http://click2hit.com/garciniacambogiahca,1,2,-1
05:04:2014,garciniacambogiaplus,http://click2hit.com/garciniacambogiaplus,1133,1133,0
05:04:2014,garciniacambogiapro,http://click2hit.com/garciniacambogiapro,16,16,0
05:04:2014,garciniacambogiaselect,http://click2hit.com/garciniacambogiaselect,485,486,-1
05:04:2014,garciniacambogiaslimfast,http://click2hit.com/garciniacambogiaslimfast,1780,1780,0
05:04:2014,garciniacambogiaslimsystem,http://click2hit.com/garciniacambogiaslimsystem,1091,1095,-4
05:04:2014,garciniacambogiaxt,http://click2hit.com/garciniacambogiaxt,137,144,-7
05:04:2014,garciniacambogiaz,http://click2hit.com/garciniacambogiaz,0,1,-1
05:04:2014,garciniacombogiasupreme,http://click2hit.com/garciniacombogiasupreme,22,22,0
05:04:2014,garciniadietmax,http://click2hit.com/garciniadietmax,309,321,-12
05:04:2014,garciniaextractplus,http://click2hit.com/garciniaextractplus,231,231,0
05:04:2014,garciniaforte,http://click2hit.com/garciniaforte,1,2,-1
05:04:2014,garciniahca,http://click2hit.com/garciniahca,139,139,0
05:04:2014,garciniahcapremium,http://click2hit.com/garciniahcapremium,94,94,0
05:04:2014,garciniaplus,http://click2hit.com/garciniaplus,1957,1963,-6
05:04:2014,garciniasuperdiet,http://click2hit.com/garciniasuperdiet,171,172,-1
05:04:2014,garciniawonder,http://click2hit.com/garciniawonder,792,803,-11
05:04:2014,garciniawow,http://click2hit.com/garciniawow,72,72,0
05:04:2014,garciniaxslim,http://click2hit.com/garciniaxslim,454,478,-24
05:04:2014,gc180xt,http://click2hit.com/gc180xt,541,545,-4
05:04:2014,gcbmaxgreencoffee,http://click2hit.com/gcbmaxgreencoffee,341,341,0
05:04:2014,gcfitsgarcinia,http://click2hit.com/gcfitsgarcinia,5,5,0
05:04:2014,gcxsdiet,http://click2hit.com/gcxsdiet,36,36,0
05:04:2014,genesis,http://click2hit.com/genesis,41,42,-1
05:04:2014,gogiberryburn,http://click2hit.com/gogiberryburn,7,14,-7
05:04:2014,gojiactives,http://click2hit.com/gojiactives,1459,1467,-8
05:04:2014,gojiadvance,http://click2hit.com/gojiadvance,381,381,0
05:04:2014,gojimax,http://click2hit.com/gojimax,233,236,-3
05:04:2014,gojislim,http://click2hit.com/gojislim,20132,20153,-21
05:04:2014,govapor,http://click2hit.com/govapor,61,87,-26
05:04:2014,greencoffeebeanthin,http://click2hit.com/greencoffeebeanthin,281,281,0
05:04:2014,greencoffeebody,http://click2hit.com/greencoffeebody,414,415,-1
05:04:2014,greencoffeecleanse,http://click2hit.com/greencoffeecleanse,17,17,0
05:04:2014,greencoffeecleanse1,http://click2hit.com/greencoffeecleanse1,24,26,-2
05:04:2014,greencoffeecleanses,http://click2hit.com/greencoffeecleanses,711,738,-27
05:04:2014,greencoffeeextraslim,http://click2hit.com/greencoffeeextraslim,270,272,-2
05:04:2014,greencoffeefatburn,http://click2hit.com/greencoffeefatburn,1560,1561,-1
05:04:2014,greencoffeenaxx,http://click2hit.com/greencoffeenaxx,194,194,0
05:04:2014,greencoffeeplus,http://click2hit.com/greencoffeeplus,100,100,0
05:04:2014,greencoffeeprogram,http://click2hit.com/greencoffeeprogram,53,54,-1
05:04:2014,greencoffeerevolution,http://click2hit.com/greencoffeerevolution,20,24,-4
05:04:2014,greencoffeespeedslim,http://click2hit.com/greencoffeespeedslim,1271,1291,-20
05:04:2014,greencoffeesupreme,http://click2hit.com/greencoffeesupreme,345,345,0
05:04:2014,greencoffeesupremecleanse,http://click2hit.com/greencoffeesupremecleanse,115,116,-1
05:04:2014,greendetoxpatch,http://click2hit.com/greendetoxpatch,282,283,-1
05:04:2014,greenleancoffeebean,http://click2hit.com/greenleancoffeebean,204,206,-2
05:04:2014,greentonepromuscle,http://click2hit.com/greentonepromuscle,212,213,-1
05:04:2014,growxl,http://click2hit.com/growxl,2692,2699,-7
05:04:2014,hairgenesis,http://click2hit.com/hairgenesis,78,79,-1
05:04:2014,hardknight,http://click2hit.com/hardknight,1417,1424,-7
05:04:2014,hardknight-1,http://click2hit.com/hardknight-1,79,80,-1
05:04:2014,hawaiislim,http://click2hit.com/hawaiislim,136,137,-1
05:04:2014,healthycleanse,http://click2hit.com/healthycleanse,510,511,-1
05:04:2014,heboost,http://click2hit.com/heboost,233,234,-1
05:04:2014,hghfuel,http://click2hit.com/hghfuel,20,23,-3
05:04:2014,hghpro,http://click2hit.com/hghpro,7,9,-2
05:04:2014,hghxl,http://click2hit.com/hghxl,134,135,-1
05:04:2014,hight,http://click2hit.com/hight,322,324,-2
05:04:2014,hspactives,http://click2hit.com/hspactives,2141,2151,-10
05:04:2014,htrush,http://click2hit.com/htrush,292,297,-5
05:04:2014,hydradiance,http://click2hit.com/hydradiance,502,513,-11
05:04:2014,hydrafirm,http://click2hit.com/hydrafirm,252,252,0
05:04:2014,hydravella,http://click2hit.com/hydravella,223,225,-2
05:04:2014,hydroface,http://click2hit.com/hydroface,616,618,-2
05:04:2014,hydroxatone90,http://click2hit.com/hydroxatone90,321,322,-1
05:04:2014,hydroxatonebbcream,http://click2hit.com/hydroxatonebbcream,72,72,0
05:04:2014,idolize,http://click2hit.com/idolize,85,102,-17
05:04:2014,instaleanketones,http://click2hit.com/instaleanketones,695,695,0
05:04:2014,instantderma,http://click2hit.com/instantderma,183,185,-2
05:04:2014,instantlift,http://click2hit.com/instantlift,471,471,0
05:04:2014,juvalife,http://click2hit.com/juvalife,86,88,-2
05:04:2014,juvamend,http://click2hit.com/juvamend,181,0,181
05:04:2014,juvesiio,http://click2hit.com/juvesiio,56,56,0
05:04:2014,ketoneadvanced,http://click2hit.com/ketoneadvanced,62,79,-17
05:04:2014,ketonepremium,http://click2hit.com/ketonepremium,528,529,-1
05:04:2014,kollagen,http://click2hit.com/kollagen,76,78,-2
05:04:2014,l-carnitineplus,http://click2hit.com/l-carnitineplus,144,145,-1
05:04:2014,ladermanique,http://click2hit.com/ladermanique,1715,1718,-3
05:04:2014,larginineplus,http://click2hit.com/larginineplus,30,30,0
05:04:2014,leanmusclex,http://click2hit.com/leanmusclex,4,5,-1
05:04:2014,leptizin,http://click2hit.com/leptizin,101,103,-2
05:04:2014,lifecell,http://click2hit.com/lifecell,140,140,0
05:04:2014,liftandglowpro,http://click2hit.com/liftandglowpro,36,36,0
05:04:2014,liftderma,http://click2hit.com/liftderma,754,756,-2
05:04:2014,liftserumpro,http://click2hit.com/liftserumpro,53,53,0
05:04:2014,liftvapor,http://click2hit.com/liftvapor,894,894,0
05:04:2014,lipo13,http://click2hit.com/lipo13,786,841,-55
05:04:2014,lipog3,http://click2hit.com/lipog3,271,320,-49
05:04:2014,liposlim,http://click2hit.com/liposlim,209,209,0
05:04:2014,lisocleanse,http://click2hit.com/lisocleanse,57,75,-18
05:04:2014,lorelia,http://click2hit.com/lorelia,2052,2075,-23
05:04:2014,lumeraeyeserum,http://click2hit.com/lumeraeyeserum,2202,2214,-12
05:04:2014,luminant,http://click2hit.com/luminant,396,396,0
05:04:2014,luminantskin,http://click2hit.com/luminantskin,411,411,0
05:04:2014,luminique,http://click2hit.com/luminique,83,83,0
05:04:2014,luministeyegel,http://click2hit.com/luministeyegel,209,209,0
05:04:2014,lunarsleep,http://click2hit.com/lunarsleep,235,256,-21
05:04:2014,lunathin,http://click2hit.com/lunathin,141,142,-1
05:04:2014,lxwpro-t,http://click2hit.com/lxwpro-t,14,19,-5
05:04:2014,lysocleanse,http://click2hit.com/lysocleanse,737,756,-19
05:04:2014,massivevitality,http://click2hit.com/massivevitality,27,28,-1
05:04:2014,masspmnight,http://click2hit.com/masspmnight,36,38,-2
05:04:2014,maxburncambogia,http://click2hit.com/maxburncambogia,6876,6891,-15
05:04:2014,maxcleanse,http://click2hit.com/maxcleanse,272,272,0
05:04:2014,maxdetox,http://click2hit.com/maxdetox,375,376,-1
05:04:2014,maxgarciniaburn,http://click2hit.com/maxgarciniaburn,251,258,-7
05:04:2014,maxleanx,http://click2hit.com/maxleanx,279,279,0
05:04:2014,maxlight,http://click2hit.com/maxlight,5,9,-4
05:04:2014,maxmuscleblast,http://click2hit.com/maxmuscleblast,34,34,0
05:04:2014,maxmusclelean,http://click2hit.com/maxmusclelean,47,47,0
05:04:2014,maxtrimraspberryketone,http://click2hit.com/maxtrimraspberryketone,106,107,-1
05:04:2014,maxxmale,http://click2hit.com/maxxmale,183,183,0
05:04:2014,maxxtest300,http://click2hit.com/maxxtest300,19,23,-4
05:04:2014,miraclegarciniacambogia1300,http://click2hit.com/miraclegarciniacambogia1300,49,50,-1
05:04:2014,miraclegarciniacambogiarx,http://click2hit.com/miraclegarciniacambogiarx,53,57,-4
05:04:2014,miraclephytoceramides,http://click2hit.com/miraclephytoceramides,2107,2142,-35
05:04:2014,miracleraspberryketone,http://click2hit.com/miracleraspberryketone,23,24,-1
05:04:2014,mitoslim,http://click2hit.com/mitoslim,749,749,0
05:04:2014,mizulean,http://click2hit.com/mizulean,245,245,0
05:04:2014,musclecorex,http://click2hit.com/musclecorex,514,514,0
05:04:2014,muscleforcex,http://click2hit.com/muscleforcex,88,89,-1
05:04:2014,musclekingpro,http://click2hit.com/musclekingpro,301,302,-1
05:04:2014,musclemax,http://click2hit.com/musclemax,226,226,0
05:04:2014,muscleripx,http://click2hit.com/muscleripx,197,204,-7
05:04:2014,musclexedge,http://click2hit.com/musclexedge,525,525,0
05:04:2014,musclexpro,http://click2hit.com/musclexpro,93,93,0
05:04:2014,musclezx90,http://click2hit.com/musclezx90,2901,2901,0
05:04:2014,naturalburn,http://click2hit.com/naturalburn,258,258,0
05:04:2014,naturalcleanse,http://click2hit.com/naturalcleanse,812,812,0
05:04:2014,naturalcoloncleanseelite,http://click2hit.com/naturalcoloncleanseelite,314,318,-4
05:04:2014,naturaldiet,http://click2hit.com/naturaldiet,145,146,-1
05:04:2014,naturalgarciniacambogiaburn,http://click2hit.com/naturalgarciniacambogiaburn,231,236,-5
05:04:2014,naturalgreencleanse,http://click2hit.com/naturalgreencleanse,542,545,-3
05:04:2014,naturalgreencoffeeburn,http://click2hit.com/naturalgreencoffeeburn,423,423,0
05:04:2014,naturalpluscleanse,http://click2hit.com/naturalpluscleanse,125,127,-2
05:04:2014,naturalpurecleanse,http://click2hit.com/naturalpurecleanse,393,393,0
05:04:2014,neucleanseultimate,http://click2hit.com/neucleanseultimate,421,426,-5
05:04:2014,neugarciniacambogia,http://click2hit.com/neugarciniacambogia,12,14,-2
05:04:2014,neuropathysupportformula,http://click2hit.com/neuropathysupportformula,241,244,-3
05:04:2014,newagecleanse,http://click2hit.com/newagecleanse,325,329,-4
05:04:2014,newlifecleanse,http://click2hit.com/newlifecleanse,154,154,0
05:04:2014,nidora,http://click2hit.com/nidora,480,505,-25
05:04:2014,nitricmaxmuscle,http://click2hit.com/nitricmaxmuscle,317,317,0
05:04:2014,nitricmaxmuscle1,http://click2hit.com/nitricmaxmuscle1,60,60,0
05:04:2014,nitricpower,http://click2hit.com/nitricpower,2,3,-1
05:04:2014,nitroxin,http://click2hit.com/nitroxin,29,30,-1
05:04:2014,nitroxl,http://click2hit.com/nitroxl,282,282,0
05:04:2014,nitroxpro,http://click2hit.com/nitroxpro,6254,6363,-109
05:04:2014,no2explodeextreme,http://click2hit.com/no2explodeextreme,1480,1488,-8
05:04:2014,no2factor,http://click2hit.com/no2factor,330,330,0
05:04:2014,no2maximus,http://click2hit.com/no2maximus,2327,2355,-28
05:04:2014,no2surge,http://click2hit.com/no2surge,189,207,-18
05:04:2014,nuetrim,http://click2hit.com/nuetrim,428,429,-1
05:04:2014,nutraburn10,http://click2hit.com/nutraburn10,95,95,0
05:04:2014,nutranaturalgarciniacambogia,http://click2hit.com/nutranaturalgarciniacambogia,114,115,-1
05:04:2014,nutridiet,http://click2hit.com/nutridiet,968,974,-6
05:04:2014,nuvagenic,http://click2hit.com/nuvagenic,196,197,-1
05:04:2014,nuvie,http://click2hit.com/nuvie,151,155,-4
05:04:2014,nuvocleanse,http://click2hit.com/nuvocleanse,591,591,0
05:04:2014,nuvoslim,http://click2hit.com/nuvoslim,337,357,-20
05:04:2014,onemoment,http://click2hit.com/onemoment,88,104,-16
05:04:2014,optimalstack,http://click2hit.com/optimalstack,458,461,-3
05:04:2014,organiccleanse,http://click2hit.com/organiccleanse,2,3,-1
05:04:2014,organiccleansedetox,http://click2hit.com/organiccleansedetox,51,54,-3
05:04:2014,organicgarciniacambogia,http://click2hit.com/organicgarciniacambogia,194,195,-1
05:04:2014,originalgarciniacambogia,http://click2hit.com/originalgarciniacambogia,47,47,0
05:04:2014,originalyaconextract,http://click2hit.com/originalyaconextract,151,151,0
05:04:2014,originalyaconsyrup,http://click2hit.com/originalyaconsyrup,55,56,-1
05:04:2014,orvigomax,http://click2hit.com/orvigomax,36,43,-7
05:04:2014,ourgreencleanse,http://click2hit.com/ourgreencleanse,144,145,-1
05:04:2014,oxygenius,http://click2hit.com/oxygenius,1319,1332,-13
05:04:2014,pelevoni,http://click2hit.com/pelevoni,318,318,0
05:04:2014,platinumgarciniacambogia,http://click2hit.com/platinumgarciniacambogia,355,355,0
05:04:2014,poshcream,http://click2hit.com/poshcream,24,24,0
05:04:2014,powermax,http://click2hit.com/powermax,3,7,-4
05:04:2014,powerprecision,http://click2hit.com/powerprecision,113,113,0
05:04:2014,poweruphealthgarcinia,http://click2hit.com/poweruphealthgarcinia,90,111,-21
05:04:2014,premiermangocleanse,http://click2hit.com/premiermangocleanse,204,204,0
05:04:2014,premiumgarciniacambogiaslim,http://click2hit.com/premiumgarciniacambogiaslim,42,73,-31
05:04:2014,premiumgreencoffeebean,http://click2hit.com/premiumgreencoffeebean,207,207,0
05:04:2014,procollagen,http://click2hit.com/procollagen,266,266,0
05:04:2014,procoloncleanse,http://click2hit.com/procoloncleanse,167,167,0
05:04:2014,prodermagenix,http://click2hit.com/prodermagenix,185,185,0
05:04:2014,prodermagenixplus,http://click2hit.com/prodermagenixplus,256,256,0
05:04:2014,progain350,http://click2hit.com/progain350,3,3,0
05:04:2014,prolong,http://click2hit.com/prolong,520,562,-42
05:04:2014,prolongz,http://click2hit.com/prolongz,420,437,-17
05:04:2014,promusclecomplex,http://click2hit.com/promusclecomplex,534,536,-2
05:04:2014,pronutragarcinia,http://click2hit.com/pronutragarcinia,51,53,-2
05:04:2014,protrim,http://click2hit.com/protrim,1045,1046,-1
05:04:2014,purafit,http://click2hit.com/purafit,364,364,0
05:04:2014,puragreencoffee,http://click2hit.com/puragreencoffee,286,287,-1
05:04:2014,pureberrymax,http://click2hit.com/pureberrymax,267,267,0
05:04:2014,purebiodiet,http://click2hit.com/purebiodiet,639,643,-4
05:04:2014,purecambogiaultra,http://click2hit.com/purecambogiaultra,178,184,-6
05:04:2014,purecambogiaultra-1,http://click2hit.com/purecambogiaultra-1,572,583,-11
05:04:2014,purecambogiaultra2,http://click2hit.com/purecambogiaultra2,172,172,0
05:04:2014,purecleanse,http://click2hit.com/purecleanse,499,499,0
05:04:2014,purecleansemax,http://click2hit.com/purecleansemax,231,234,-3
05:04:2014,purecolocleanse,http://click2hit.com/purecolocleanse,264,265,-1
05:04:2014,purecoloncleanser,http://click2hit.com/purecoloncleanser,1539,1546,-7
05:04:2014,puregarciniacambogia,http://click2hit.com/puregarciniacambogia,195,195,0
05:04:2014,puregarciniacambogia-1,http://click2hit.com/puregarciniacambogia-1,7451,7548,-97
05:04:2014,puregarciniacambogiaburn,http://click2hit.com/puregarciniacambogiaburn,2323,2324,-1
05:04:2014,puregarciniacambogiaplus,http://click2hit.com/puregarciniacambogiaplus,372,372,0
05:04:2014,puregarciniacambogiapremium,http://click2hit.com/puregarciniacambogiapremium,1211,1217,-6
05:04:2014,puregarciniacambogiaslim,http://click2hit.com/puregarciniacambogiaslim,890,891,-1
05:04:2014,puregarciniacambogiaslimsystem,http://click2hit.com/puregarciniacambogiaslimsystem,252,252,0
05:04:2014,puregarciniacanada,http://click2hit.com/puregarciniacanada,54,54,0
05:04:2014,puregarciniaelite,http://click2hit.com/puregarciniaelite,31,31,0
05:04:2014,puregarciniaslim,http://click2hit.com/puregarciniaslim,343,173,170
05:04:2014,puregarciniaultra,http://click2hit.com/puregarciniaultra,513,518,-5
05:04:2014,puregarciniaultra-1,http://click2hit.com/puregarciniaultra-1,134,134,0
05:04:2014,puregreencoffee,http://click2hit.com/puregreencoffee,419,419,0
05:04:2014,puregreencoffeebeanplus,http://click2hit.com/puregreencoffeebeanplus,1767,5,1762
05:04:2014,purelifecleanse1,http://click2hit.com/purelifecleanse1,178,244,-66
05:04:2014,purenitrate,http://click2hit.com/purenitrate,53,68,-15
05:04:2014,purenitromax,http://click2hit.com/purenitromax,487,489,-2
05:04:2014,purensa,http://click2hit.com/purensa,1638,1643,-5
05:04:2014,pureraspberryketonepremium,http://click2hit.com/pureraspberryketonepremium,229,232,-3
05:04:2014,puressance,http://click2hit.com/puressance,124,124,0
05:04:2014,purestgarciniacambogia,http://click2hit.com/purestgarciniacambogia,19,19,0
05:04:2014,pureyaconsyrupextract,http://click2hit.com/pureyaconsyrupextract,254,254,0
05:04:2014,pureyaconsyrupplus,http://click2hit.com/pureyaconsyrupplus,141,142,-1
05:04:2014,pureyaconxt,http://click2hit.com/pureyaconxt,72,72,0
05:04:2014,px800greencoffee,http://click2hit.com/px800greencoffee,55,56,-1
05:04:2014,quickgreencoffee,http://click2hit.com/quickgreencoffee,392,393,-1
05:04:2014,raspberryketonefresh,http://click2hit.com/raspberryketonefresh,1053,1058,-5
05:04:2014,raspberryketoneproslim,http://click2hit.com/raspberryketoneproslim,297,301,-4
05:04:2014,raspberryketones,http://click2hit.com/raspberryketones,308,314,-6
05:04:2014,raspberryslimplus,http://click2hit.com/raspberryslimplus,178,178,0
05:04:2014,raspberrytones,http://click2hit.com/raspberrytones,357,358,-1
05:04:2014,raspberrytrim,http://click2hit.com/raspberrytrim,148,148,0
05:04:2014,raspberryultraketone,http://click2hit.com/raspberryultraketone,194,196,-2
05:04:2014,rawburn,http://click2hit.com/rawburn,144,145,-1
05:04:2014,regularx,http://click2hit.com/regularx,76,85,-9
05:04:2014,rejouvance,http://click2hit.com/rejouvance,478,478,0
05:04:2014,rejuvaglow,http://click2hit.com/rejuvaglow,65,65,0
05:04:2014,rejuvalash,http://click2hit.com/rejuvalash,253,253,0
05:04:2014,rejuvalskin,http://click2hit.com/rejuvalskin,6,19,-13
05:04:2014,rejuvenex,http://click2hit.com/rejuvenex,351,351,0
05:04:2014,reliftadvanced,http://click2hit.com/reliftadvanced,265,266,-1
05:04:2014,renique,http://click2hit.com/renique,635,642,-7
05:04:2014,restore,http://click2hit.com/restore,82,82,0
05:04:2014,revitol,http://click2hit.com/revitol,61,61,0
05:04:2014,revivagenix,http://click2hit.com/revivagenix,227,227,0
05:04:2014,revivasol,http://click2hit.com/revivasol,2225,2232,-7
05:04:2014,revolyn,http://click2hit.com/revolyn,213,213,0
05:04:2014,revoreplex,http://click2hit.com/revoreplex,3,206,-203
05:04:2014,rippedmusclex,http://click2hit.com/rippedmusclex,12,12,0
05:04:2014,rvtl,http://click2hit.com/rvtl,1870,1877,-7
05:04:2014,saphireecig,http://click2hit.com/saphireecig,588,588,0
05:04:2014,secretbodybulk,http://click2hit.com/secretbodybulk,305,305,0
05:04:2014,secretgarciniacambogia,http://click2hit.com/secretgarciniacambogia,249,249,0
05:04:2014,secretlift,http://click2hit.com/secretlift,3,4,-1
05:04:2014,sensa,http://click2hit.com/sensa,131,131,0
05:04:2014,simplycleanse,http://click2hit.com/simplycleanse,232,233,-1
05:04:2014,simplygarciniacambogia,http://click2hit.com/simplygarciniacambogia,427,429,-2
05:04:2014,simplygreencoffee,http://click2hit.com/simplygreencoffee,323,324,-1
05:04:2014,skinliftadvanced,http://click2hit.com/skinliftadvanced,219,221,-2
05:04:2014,skinnyfiber,http://click2hit.com/skinnyfiber,397,397,0
05:04:2014,slendera-1,http://click2hit.com/slendera-1,39,39,0
05:04:2014,slendera-sab,http://click2hit.com/slendera-sab,67,67,0
05:04:2014,slimberrymax,http://click2hit.com/slimberrymax,252,254,-2
05:04:2014,slimbodycleanse,http://click2hit.com/slimbodycleanse,3084,3086,-2
05:04:2014,slimbodyketones,http://click2hit.com/slimbodyketones,94,102,-8
05:04:2014,slimcleanseplus,http://click2hit.com/slimcleanseplus,108,109,-1
05:04:2014,slimlean,http://click2hit.com/slimlean,1032,1033,-1
05:04:2014,slimnogym,http://click2hit.com/slimnogym,222,222,0
05:04:2014,slimtrimpm,http://click2hit.com/slimtrimpm,5,20,-15
05:04:2014,smileprodirect,http://click2hit.com/smileprodirect,2868,2887,-19
05:04:2014,solpria,http://click2hit.com/solpria,1077,1079,-2
05:04:2014,sparkwhitening,http://click2hit.com/sparkwhitening,1602,1602,0
05:04:2014,strawberrygarciniacambogia,http://click2hit.com/strawberrygarciniacambogia,422,429,-7
05:04:2014,superbetaprostate,http://click2hit.com/superbetaprostate,152,152,0
05:04:2014,supercoloncleanse1800,http://click2hit.com/supercoloncleanse1800,288,288,0
05:04:2014,supergarciniacambogia,http://click2hit.com/supergarciniacambogia,949,968,-19
05:04:2014,superiorvelvet,http://click2hit.com/superiorvelvet,438,449,-11
05:04:2014,superketoneplus,http://click2hit.com/superketoneplus,3947,3968,-21
05:04:2014,superlean,http://click2hit.com/superlean,200,200,0
05:04:2014,superleancoloncleanse,http://click2hit.com/superleancoloncleanse,1312,1317,-5
05:04:2014,supertestoboost,http://click2hit.com/supertestoboost,128,129,-1
05:04:2014,superyaconsyrup1000,http://click2hit.com/superyaconsyrup1000,22,23,-1
05:04:2014,supracleanse350,http://click2hit.com/supracleanse350,550,564,-14
05:04:2014,supremeantler,http://click2hit.com/supremeantler,126,128,-2
05:04:2014,svelme,http://click2hit.com/svelme,46,46,0
05:04:2014,swolecreatinemuscle,http://click2hit.com/swolecreatinemuscle,186,186,0
05:04:2014,syneocell,http://click2hit.com/syneocell,188,188,0
05:04:2014,tadvance,http://click2hit.com/tadvance,468,468,0
05:04:2014,testabolancyp,http://click2hit.com/testabolancyp,343,343,0
05:04:2014,testocoreadvanced,http://click2hit.com/testocoreadvanced,251,253,-2
05:04:2014,testoforceedge,http://click2hit.com/testoforceedge,475,477,-2
05:04:2014,testoforcex,http://click2hit.com/testoforcex,293,293,0
05:04:2014,testolimit,http://click2hit.com/testolimit,34,34,0
05:04:2014,testomax,http://click2hit.com/testomax,274,274,0
05:04:2014,testoril,http://click2hit.com/testoril,520,521,-1
05:04:2014,testorushrx,http://click2hit.com/testorushrx,367,380,-13
05:04:2014,testoupmax,http://click2hit.com/testoupmax,66,76,-10
05:04:2014,testrx360,http://click2hit.com/testrx360,331,331,0
05:04:2014,testtoforcextreme,http://click2hit.com/testtoforcextreme,383,384,-1
05:04:2014,testx180,http://click2hit.com/testx180,1376,1382,-6
05:04:2014,thermoblackx,http://click2hit.com/thermoblackx,138,138,0
05:04:2014,thermoextreme1,http://click2hit.com/thermoextreme1,568,569,-1
05:04:2014,thermofactorx,http://click2hit.com/thermofactorx,812,814,-2
05:04:2014,thermosculptpro,http://click2hit.com/thermosculptpro,317,319,-2
05:04:2014,titaniumprox,http://click2hit.com/titaniumprox,783,783,0
05:04:2014,tlevelboost,http://click2hit.com/tlevelboost,62,63,-1
05:04:2014,tonaderm,http://click2hit.com/tonaderm,195,199,-4
05:04:2014,totalcleansecomplete,http://click2hit.com/totalcleansecomplete,331,341,-10
05:04:2014,trigx2,http://click2hit.com/trigx2,328,328,0
05:04:2014,trimextrin,http://click2hit.com/trimextrin,171,172,-1
05:04:2014,truburnplus,http://click2hit.com/truburnplus,26,27,-1
05:04:2014,truecleansecomplete,http://click2hit.com/truecleansecomplete,123,133,-10
05:04:2014,turbofrce,http://click2hit.com/turbofrce,416,417,-1
05:04:2014,ultracelebdiet,http://click2hit.com/ultracelebdiet,355,356,-1
05:04:2014,ultracleansepure,http://click2hit.com/ultracleansepure,351,363,-12
05:04:2014,ultracoloncleanse,http://click2hit.com/ultracoloncleanse,40,41,-1
05:04:2014,ultrafinesse,http://click2hit.com/ultrafinesse,75,81,-6
05:04:2014,ultragarciniacambogia,http://click2hit.com/ultragarciniacambogia,46,46,0
05:04:2014,ultramaxtestosterone,http://click2hit.com/ultramaxtestosterone,226,226,0
05:04:2014,ultraslim,http://click2hit.com/ultraslim,187,187,0
05:04:2014,umoris,http://click2hit.com/umoris,393,394,-1
05:04:2014,vantage,http://click2hit.com/vantage,0,3,-3
05:04:2014,vapexecig,http://click2hit.com/vapexecig,337,337,0
05:04:2014,vimaxdetox,http://click2hit.com/vimaxdetox,874,877,-3
05:04:2014,virilityex,http://click2hit.com/virilityex,201,202,-1
05:04:2014,vitaberryburn,http://click2hit.com/vitaberryburn,369,371,-2
05:04:2014,vitaberrytrim,http://click2hit.com/vitaberrytrim,1795,1795,0
05:04:2014,vitacleanse,http://click2hit.com/vitacleanse,4400,4418,-18
05:04:2014,vitaketone,http://click2hit.com/vitaketone,918,924,-6
05:04:2014,vitalcleanse,http://click2hit.com/vitalcleanse,181,181,0
05:04:2014,vitalcleansecomplete,http://click2hit.com/vitalcleansecomplete,734,742,-8
05:04:2014,vitalifedetox,http://click2hit.com/vitalifedetox,732,735,-3
05:04:2014,vitalikortest,http://click2hit.com/vitalikortest,592,592,0
05:04:2014,vitalipo,http://click2hit.com/vitalipo,117,119,-2
05:04:2014,vitalitygreencoffee,http://click2hit.com/vitalitygreencoffee,197,197,0
05:04:2014,vitamaxgarciniacambogia,http://click2hit.com/vitamaxgarciniacambogia,1719,1746,-27
05:04:2014,vyalis,http://click2hit.com/vyalis,232,232,0
05:04:2014,wrinklerewind,http://click2hit.com/wrinklerewind,5617,5646,-29
05:04:2014,xmrecovery,http://click2hit.com/xmrecovery,141,141,0
05:04:2014,xtremegarciniacambogia,http://click2hit.com/xtremegarciniacambogia,482,482,0
05:04:2014,xtremenitro,http://click2hit.com/xtremenitro,1468,18,1450
05:04:2014,xtremetestosteronebooster,http://click2hit.com/xtremetestosteronebooster,360,360,0
05:04:2014,yaconmolasses,http://click2hit.com/yaconmolasses,79,80,-1
05:04:2014,yaconrootmax,http://click2hit.com/yaconrootmax,916,946,-30
05:04:2014,yaconsyrupdirect,http://click2hit.com/yaconsyrupdirect,213,213,0
05:04:2014,yolosleep,http://click2hit.com/yolosleep,211,212,-1
05:04:2014,youthkitantiaging,http://click2hit.com/youthkitantiaging,194,194,0
05:04:2014,zenacose,http://click2hit.com/zenacose,161,161,0
05:04:2014,zenscleanse,http://click2hit.com/zenscleanse,2599,2601,-2
05:04:2014,zinncollection,http://click2hit.com/zinncollection,175,177,-2
05:04:2014,zolyria,http://click2hit.com/zolyria,473,480,-7
05:04:2014,zyloslim,http://click2hit.com/zyloslim,3724,3731,-7
05:04:2014,zymbiotix,http://click2hit.com/zymbiotix,1193,1213,-20
