dt_today,sitetitle,sitelink,pre_click,new_clicks,difrnce
08:04:2014,5stargarciniacambogia,http://click2hit.com/5stargarciniacambogia,86,87,-1
08:04:2014,Adrenalast,http://click2hit.com/Adrenalast,547,548,-1
08:04:2014,Anataflex,http://click2hit.com/Anataflex,1293,1296,-3
08:04:2014,Diabetix,http://click2hit.com/Diabetix,725,725,0
08:04:2014,Equinox,http://click2hit.com/Equinox,8603,8640,-37
08:04:2014,LuxeCoat,http://click2hit.com/LuxeCoat,412,413,-1
08:04:2014,NOX360,http://click2hit.com/NOX360,52,53,-1
08:04:2014,Prescopodene,http://click2hit.com/Prescopodene,1356,1356,0
08:04:2014,Puregarciniaslim,http://click2hit.com/Puregarciniaslim,173,345,-172
08:04:2014,RevoReplex,http://click2hit.com/RevoReplex,206,4,202
08:04:2014,absoluteraspberryketone,http://click2hit.com/absoluteraspberryketone,8,9,-1
08:04:2014,acaiberrypuremax,http://click2hit.com/acaiberrypuremax,174,174,0
08:04:2014,actionprowhite,http://click2hit.com/actionprowhite,68,93,-25
08:04:2014,activedetoxcleanse,http://click2hit.com/activedetoxcleanse,29,30,-1
08:04:2014,activeraspberryketone,http://click2hit.com/activeraspberryketone,72,100,-28
08:04:2014,advancedgarciniacambogia,http://click2hit.com/advancedgarciniacambogia,778,778,0
08:04:2014,advancedpuregarcinia,http://click2hit.com/advancedpuregarcinia,552,553,-1
08:04:2014,advancedtest,http://click2hit.com/advancedtest,571,571,0
08:04:2014,advancedtrimgreencoffee,http://click2hit.com/advancedtrimgreencoffee,1672,1678,-6
08:04:2014,africanmangopremier,http://click2hit.com/africanmangopremier,743,744,-1
08:04:2014,agelesshealthsolution,http://click2hit.com/agelesshealthsolution,122,123,-1
08:04:2014,alleureantiagingcream,http://click2hit.com/alleureantiagingcream,192,240,-48
08:04:2014,alleureeyeserum,http://click2hit.com/alleureeyeserum,220,270,-50
08:04:2014,aloeferoxcleanse,http://click2hit.com/aloeferoxcleanse,1308,1323,-15
08:04:2014,aloeveracleanse,http://click2hit.com/aloeveracleanse,642,644,-2
08:04:2014,alore,http://click2hit.com/alore,3904,3920,-16
08:04:2014,alphacuthd,http://click2hit.com/alphacuthd,44,48,-4
08:04:2014,alphagenix,http://click2hit.com/alphagenix,47,57,-10
08:04:2014,alphamale,http://click2hit.com/alphamale,197,197,0
08:04:2014,alphamax1,http://click2hit.com/alphamax1,254,254,0
08:04:2014,amacari,http://click2hit.com/amacari,153,153,0
08:04:2014,amazingcleanse,http://click2hit.com/amazingcleanse,2,2,0
08:04:2014,ambitrimrx,http://click2hit.com/ambitrimrx,772,772,0
08:04:2014,amino,http://click2hit.com/amino,1270,1270,0
08:04:2014,andromale,http://click2hit.com/andromale,534,535,-1
08:04:2014,anoradrol,http://click2hit.com/anoradrol,85,85,0
08:04:2014,aussiegarciniacambogia,http://click2hit.com/aussiegarciniacambogia,157,158,-1
08:04:2014,authenticgarciniacambogia,http://click2hit.com/authenticgarciniacambogia,71,73,-2
08:04:2014,beaute,http://click2hit.com/beaute,646,648,-2
08:04:2014,bellaathome,http://click2hit.com/bellaathome,1758,1760,-2
08:04:2014,bellapure,http://click2hit.com/bellapure,1724,1738,-14
08:04:2014,bellecomplex,http://click2hit.com/bellecomplex,640,645,-5
08:04:2014,berryherbalcleanse,http://click2hit.com/berryherbalcleanse,572,572,0
08:04:2014,berrythingarciniacambogia,http://click2hit.com/berrythingarciniacambogia,540,540,0
08:04:2014,betaalalinemax,http://click2hit.com/betaalalinemax,570,570,0
08:04:2014,betaboost,http://click2hit.com/betaboost,108,108,0
08:04:2014,betaforce,http://click2hit.com/betaforce,654,655,-1
08:04:2014,beyondraspberryketone,http://click2hit.com/beyondraspberryketone,2099,2100,-1
08:04:2014,biocareslimplus,http://click2hit.com/biocareslimplus,312,312,0
08:04:2014,biocarexl,http://click2hit.com/biocarexl,326,327,-1
08:04:2014,biogeniste,http://click2hit.com/biogeniste,448,449,-1
08:04:2014,blackbullmaleenhancement,http://click2hit.com/blackbullmaleenhancement,1456,1457,-1
08:04:2014,blackdiamond,http://click2hit.com/blackdiamond,447,471,-24
08:04:2014,blacklineelite,http://click2hit.com/blacklineelite,1471,1506,-35
08:04:2014,blastxl,http://click2hit.com/blastxl,143,144,-1
08:04:2014,blizzadwhite,http://click2hit.com/blizzadwhite,21,22,-1
08:04:2014,bluemagicplus,http://click2hit.com/bluemagicplus,869,870,-1
08:04:2014,bodyfuelxs,http://click2hit.com/bodyfuelxs,89,90,-1
08:04:2014,brandnew,http://click2hit.com/brandnew,351,351,0
08:04:2014,brandnewbooty,http://click2hit.com/brandnewbooty,770,770,0
08:04:2014,cafevertextraminceur,http://click2hit.com/cafevertextraminceur,2266,2425,-159
08:04:2014,carbuloss,http://click2hit.com/carbuloss,363,373,-10
08:04:2014,celebritybodynow,http://click2hit.com/celebritybodynow,422,423,-1
08:04:2014,celebrityweightlosskit,http://click2hit.com/celebrityweightlosskit,360,360,0
08:04:2014,cellanafricanmango,http://click2hit.com/cellanafricanmango,2035,2160,-125
08:04:2014,cellogicaskin,http://click2hit.com/cellogicaskin,183,189,-6
08:04:2014,cenaless,http://click2hit.com/cenaless,75,75,0
08:04:2014,cenaslim,http://click2hit.com/cenaslim,387,387,0
08:04:2014,cleandetox,http://click2hit.com/cleandetox,270,271,-1
08:04:2014,cleansecatalystplus,http://click2hit.com/cleansecatalystplus,3323,3333,-10
08:04:2014,cleanseultimo,http://click2hit.com/cleanseultimo,1406,1413,-7
08:04:2014,cocogeniceyeserum,http://click2hit.com/cocogeniceyeserum,10,10,0
08:04:2014,coffeecleansemax,http://click2hit.com/coffeecleansemax,387,387,0
08:04:2014,coffeepurecleanse,http://click2hit.com/coffeepurecleanse,52,54,-2
08:04:2014,coleanse,http://click2hit.com/coleanse,2085,2090,-5
08:04:2014,collagen,http://click2hit.com/collagen,18,19,-1
08:04:2014,collagenfaceserum,http://click2hit.com/collagenfaceserum,49,49,0
08:04:2014,colodetox,http://click2hit.com/colodetox,531,532,-1
08:04:2014,colodetoxplus,http://click2hit.com/colodetoxplus,92,92,0
08:04:2014,coloncleanse1300,http://click2hit.com/coloncleanse1300,283,283,0
08:04:2014,coloncleansecomplete,http://click2hit.com/coloncleansecomplete,1296,1298,-2
08:04:2014,coloncleansetotal,http://click2hit.com/coloncleansetotal,767,770,-3
08:04:2014,colondetoxpro,http://click2hit.com/colondetoxpro,33,39,-6
08:04:2014,colonpurecleanse,http://click2hit.com/colonpurecleanse,419,420,-1
08:04:2014,colothin,http://click2hit.com/colothin,192,192,0
08:04:2014,columbiangreencoffeebean,http://click2hit.com/columbiangreencoffeebean,746,768,-22
08:04:2014,combogiaplus,http://click2hit.com/combogiaplus,331,331,0
08:04:2014,completecoffeecleanse,http://click2hit.com/completecoffeecleanse,395,400,-5
08:04:2014,complexiderm,http://click2hit.com/complexiderm,187,187,0
08:04:2014,cosimarevival,http://click2hit.com/cosimarevival,182,183,-1
08:04:2014,cosmitone,http://click2hit.com/cosmitone,1332,1335,-3
08:04:2014,csorex,http://click2hit.com/csorex,107,107,0
08:04:2014,curcovia,http://click2hit.com/curcovia,425,426,-1
08:04:2014,cutiecurves,http://click2hit.com/cutiecurves,246,246,0
08:04:2014,cytotrim,http://click2hit.com/cytotrim,2,2,0
08:04:2014,dailyeyerestoration,http://click2hit.com/dailyeyerestoration,143,150,-7
08:04:2014,dellure,http://click2hit.com/dellure,118,118,0
08:04:2014,dellurecollagen,http://click2hit.com/dellurecollagen,570,570,0
08:04:2014,dermafirm,http://click2hit.com/dermafirm,760,761,-1
08:04:2014,dermajuvenate,http://click2hit.com/dermajuvenate,2316,2339,-23
08:04:2014,dermalift,http://click2hit.com/dermalift,235,235,0
08:04:2014,dermallo,http://click2hit.com/dermallo,269,269,0
08:04:2014,dermalmeds,http://click2hit.com/dermalmeds,446,446,0
08:04:2014,dermangelie,http://click2hit.com/dermangelie,155,156,-1
08:04:2014,derminelift,http://click2hit.com/derminelift,403,404,-1
08:04:2014,dermology,http://click2hit.com/dermology,42,42,0
08:04:2014,detoxmax,http://click2hit.com/detoxmax,56,57,-1
08:04:2014,dietultimo,http://click2hit.com/dietultimo,2514,2526,-12
08:04:2014,digestItcoloncleanse,http://click2hit.com/digestItcoloncleanse,61,63,-2
08:04:2014,duplicellp199,http://click2hit.com/duplicellp199,40,43,-3
08:04:2014,duplicellp199facetherapy,http://click2hit.com/duplicellp199facetherapy,41,46,-5
08:04:2014,ecoflex,http://click2hit.com/ecoflex,126,126,0
08:04:2014,electravx,http://click2hit.com/electravx,179,179,0
08:04:2014,elevategf,http://click2hit.com/elevategf,266,266,0
08:04:2014,elite360,http://click2hit.com/elite360,68,68,0
08:04:2014,elliskin,http://click2hit.com/elliskin,503,504,-1
08:04:2014,endorev,http://click2hit.com/endorev,462,463,-1
08:04:2014,ephedrix,http://click2hit.com/ephedrix,227,227,0
08:04:2014,equivita,http://click2hit.com/equivita,7797,7837,-40
08:04:2014,essentialdetox,http://click2hit.com/essentialdetox,427,429,-2
08:04:2014,extagen,http://click2hit.com/extagen,332,332,0
08:04:2014,extremefx,http://click2hit.com/extremefx,347,348,-1
08:04:2014,eyeluminous,http://click2hit.com/eyeluminous,603,634,-31
08:04:2014,fembalance,http://click2hit.com/fembalance,362,362,0
08:04:2014,firmativ,http://click2hit.com/firmativ,804,838,-34
08:04:2014,flawlessbeauty,http://click2hit.com/flawlessbeauty,104,107,-3
08:04:2014,flexwell,http://click2hit.com/flexwell,102,102,0
08:04:2014,forceeffect,http://click2hit.com/forceeffect,235,283,-48
08:04:2014,formularezvmagic,http://click2hit.com/formularezvmagic,231,231,0
08:04:2014,fortdietmax,http://click2hit.com/fortdietmax,80,82,-2
08:04:2014,fortmaxdiet,http://click2hit.com/fortmaxdiet,73,74,-1
08:04:2014,garciniaberrythin,http://click2hit.com/garciniaberrythin,477,477,0
08:04:2014,garciniacambogia1300,http://click2hit.com/garciniacambogia1300,659,661,-2
08:04:2014,garciniacambogia360,http://click2hit.com/garciniacambogia360,15,17,-2
08:04:2014,garciniacambogia500,http://click2hit.com/garciniacambogia500,3,3,0
08:04:2014,garciniacambogiablast,http://click2hit.com/garciniacambogiablast,747,750,-3
08:04:2014,garciniacambogiaburn,http://click2hit.com/garciniacambogiaburn,94,97,-3
08:04:2014,garciniacambogiacomplex,http://click2hit.com/garciniacambogiacomplex,331,331,0
08:04:2014,garciniacambogiaextract,http://click2hit.com/garciniacambogiaextract,48,48,0
08:04:2014,garciniacambogiafit1300,http://click2hit.com/garciniacambogiafit1300,128,129,-1
08:04:2014,garciniacambogiaformula,http://click2hit.com/garciniacambogiaformula,34,36,-2
08:04:2014,garciniacambogiahca,http://click2hit.com/garciniacambogiahca,3,4,-1
08:04:2014,garciniacambogiaplus,http://click2hit.com/garciniacambogiaplus,1133,1133,0
08:04:2014,garciniacambogiapro,http://click2hit.com/garciniacambogiapro,16,18,-2
08:04:2014,garciniacambogiaselect,http://click2hit.com/garciniacambogiaselect,489,489,0
08:04:2014,garciniacambogiaslimfast,http://click2hit.com/garciniacambogiaslimfast,1786,1787,-1
08:04:2014,garciniacambogiaslimsystem,http://click2hit.com/garciniacambogiaslimsystem,1106,1126,-20
08:04:2014,garciniacambogiaxt,http://click2hit.com/garciniacambogiaxt,161,175,-14
08:04:2014,garciniacambogiaz,http://click2hit.com/garciniacambogiaz,2,2,0
08:04:2014,garciniacombogiasupreme,http://click2hit.com/garciniacombogiasupreme,23,24,-1
08:04:2014,garciniadietmax,http://click2hit.com/garciniadietmax,328,335,-7
08:04:2014,garciniaextractplus,http://click2hit.com/garciniaextractplus,231,232,-1
08:04:2014,garciniaforte,http://click2hit.com/garciniaforte,4,4,0
08:04:2014,garciniahca,http://click2hit.com/garciniahca,139,141,-2
08:04:2014,garciniahcapremium,http://click2hit.com/garciniahcapremium,100,108,-8
08:04:2014,garciniaplus,http://click2hit.com/garciniaplus,1977,1980,-3
08:04:2014,garciniasuperdiet,http://click2hit.com/garciniasuperdiet,172,173,-1
08:04:2014,garciniawonder,http://click2hit.com/garciniawonder,808,814,-6
08:04:2014,garciniawow,http://click2hit.com/garciniawow,85,90,-5
08:04:2014,garciniaxslim,http://click2hit.com/garciniaxslim,513,530,-17
08:04:2014,gc180xt,http://click2hit.com/gc180xt,552,559,-7
08:04:2014,gcbmaxgreencoffee,http://click2hit.com/gcbmaxgreencoffee,343,344,-1
08:04:2014,gcfitsgarcinia,http://click2hit.com/gcfitsgarcinia,5,6,-1
08:04:2014,gcxsdiet,http://click2hit.com/gcxsdiet,37,39,-2
08:04:2014,genesis,http://click2hit.com/genesis,42,43,-1
08:04:2014,gogiberryburn,http://click2hit.com/gogiberryburn,20,29,-9
08:04:2014,gojiactives,http://click2hit.com/gojiactives,1492,1501,-9
08:04:2014,gojiadvance,http://click2hit.com/gojiadvance,382,389,-7
08:04:2014,gojimax,http://click2hit.com/gojimax,242,245,-3
08:04:2014,gojislim,http://click2hit.com/gojislim,20191,20225,-34
08:04:2014,govapor,http://click2hit.com/govapor,104,108,-4
08:04:2014,greencoffeebeanthin,http://click2hit.com/greencoffeebeanthin,282,284,-2
08:04:2014,greencoffeebody,http://click2hit.com/greencoffeebody,415,417,-2
08:04:2014,greencoffeecleanse,http://click2hit.com/greencoffeecleanse,18,19,-1
08:04:2014,greencoffeecleanse1,http://click2hit.com/greencoffeecleanse1,27,28,-1
08:04:2014,greencoffeecleanses,http://click2hit.com/greencoffeecleanses,805,837,-32
08:04:2014,greencoffeeextraslim,http://click2hit.com/greencoffeeextraslim,272,272,0
08:04:2014,greencoffeefatburn,http://click2hit.com/greencoffeefatburn,1565,1574,-9
08:04:2014,greencoffeenaxx,http://click2hit.com/greencoffeenaxx,194,194,0
08:04:2014,greencoffeeplus,http://click2hit.com/greencoffeeplus,101,102,-1
08:04:2014,greencoffeeprogram,http://click2hit.com/greencoffeeprogram,55,59,-4
08:04:2014,greencoffeerevolution,http://click2hit.com/greencoffeerevolution,24,25,-1
08:04:2014,greencoffeespeedslim,http://click2hit.com/greencoffeespeedslim,1371,1417,-46
08:04:2014,greencoffeesupreme,http://click2hit.com/greencoffeesupreme,347,349,-2
08:04:2014,greencoffeesupremecleanse,http://click2hit.com/greencoffeesupremecleanse,118,120,-2
08:04:2014,greendetoxpatch,http://click2hit.com/greendetoxpatch,283,284,-1
08:04:2014,greenleancoffeebean,http://click2hit.com/greenleancoffeebean,207,208,-1
08:04:2014,greentonepromuscle,http://click2hit.com/greentonepromuscle,213,214,-1
08:04:2014,growxl,http://click2hit.com/growxl,2712,2718,-6
08:04:2014,hairgenesis,http://click2hit.com/hairgenesis,79,79,0
08:04:2014,hardknight,http://click2hit.com/hardknight,1433,1437,-4
08:04:2014,hardknight-1,http://click2hit.com/hardknight-1,83,84,-1
08:04:2014,hawaiislim,http://click2hit.com/hawaiislim,140,145,-5
08:04:2014,healthycleanse,http://click2hit.com/healthycleanse,513,514,-1
08:04:2014,heboost,http://click2hit.com/heboost,235,235,0
08:04:2014,hghfuel,http://click2hit.com/hghfuel,24,25,-1
08:04:2014,hghpro,http://click2hit.com/hghpro,13,16,-3
08:04:2014,hghxl,http://click2hit.com/hghxl,135,137,-2
08:04:2014,hight,http://click2hit.com/hight,324,324,0
08:04:2014,hspactives,http://click2hit.com/hspactives,2157,2158,-1
08:04:2014,htrush,http://click2hit.com/htrush,301,305,-4
08:04:2014,hydradiance,http://click2hit.com/hydradiance,531,537,-6
08:04:2014,hydrafirm,http://click2hit.com/hydrafirm,255,259,-4
08:04:2014,hydravella,http://click2hit.com/hydravella,226,227,-1
08:04:2014,hydroface,http://click2hit.com/hydroface,618,619,-1
08:04:2014,hydroxatone90,http://click2hit.com/hydroxatone90,322,322,0
08:04:2014,hydroxatonebbcream,http://click2hit.com/hydroxatonebbcream,73,73,0
08:04:2014,idolize,http://click2hit.com/idolize,123,139,-16
08:04:2014,instaleanketones,http://click2hit.com/instaleanketones,695,695,0
08:04:2014,instantderma,http://click2hit.com/instantderma,185,185,0
08:04:2014,instantlift,http://click2hit.com/instantlift,471,471,0
08:04:2014,juvalife,http://click2hit.com/juvalife,88,89,-1
08:04:2014,juvamend,http://click2hit.com/juvamend,1,3,-2
08:04:2014,juvesiio,http://click2hit.com/juvesiio,56,56,0
08:04:2014,ketoneadvanced,http://click2hit.com/ketoneadvanced,100,2,98
08:04:2014,ketonepremium,http://click2hit.com/ketonepremium,529,530,-1
08:04:2014,kollagen,http://click2hit.com/kollagen,79,81,-2
08:04:2014,l-carnitineplus,http://click2hit.com/l-carnitineplus,147,148,-1
08:04:2014,ladermanique,http://click2hit.com/ladermanique,1723,1725,-2
08:04:2014,larginineplus,http://click2hit.com/larginineplus,30,30,0
08:04:2014,leanmusclex,http://click2hit.com/leanmusclex,6,8,-2
08:04:2014,leptizin,http://click2hit.com/leptizin,103,104,-1
08:04:2014,lifecell,http://click2hit.com/lifecell,140,140,0
08:04:2014,liftandglowpro,http://click2hit.com/liftandglowpro,36,36,0
08:04:2014,liftderma,http://click2hit.com/liftderma,760,764,-4
08:04:2014,liftserumpro,http://click2hit.com/liftserumpro,54,55,-1
08:04:2014,liftvapor,http://click2hit.com/liftvapor,894,894,0
08:04:2014,lipo13,http://click2hit.com/lipo13,923,972,-49
08:04:2014,lipog3,http://click2hit.com/lipog3,434,479,-45
08:04:2014,liposlim,http://click2hit.com/liposlim,211,212,-1
08:04:2014,lisocleanse,http://click2hit.com/lisocleanse,137,186,-49
08:04:2014,lorelia,http://click2hit.com/lorelia,2114,2133,-19
08:04:2014,lumeraeyeserum,http://click2hit.com/lumeraeyeserum,2242,2257,-15
08:04:2014,luminant,http://click2hit.com/luminant,396,396,0
08:04:2014,luminantskin,http://click2hit.com/luminantskin,412,413,-1
08:04:2014,luminique,http://click2hit.com/luminique,84,85,-1
08:04:2014,luministeyegel,http://click2hit.com/luministeyegel,209,209,0
08:04:2014,lunarsleep,http://click2hit.com/lunarsleep,272,280,-8
08:04:2014,lunathin,http://click2hit.com/lunathin,142,142,0
08:04:2014,lxwpro-t,http://click2hit.com/lxwpro-t,24,27,-3
08:04:2014,lysocleanse,http://click2hit.com/lysocleanse,768,780,-12
08:04:2014,massivevitality,http://click2hit.com/massivevitality,28,30,-2
08:04:2014,masspmnight,http://click2hit.com/masspmnight,38,38,0
08:04:2014,maxburncambogia,http://click2hit.com/maxburncambogia,6904,6910,-6
08:04:2014,maxcleanse,http://click2hit.com/maxcleanse,273,273,0
08:04:2014,maxdetox,http://click2hit.com/maxdetox,376,377,-1
08:04:2014,maxgarciniaburn,http://click2hit.com/maxgarciniaburn,260,263,-3
08:04:2014,maxleanx,http://click2hit.com/maxleanx,279,280,-1
08:04:2014,maxlight,http://click2hit.com/maxlight,11,11,0
08:04:2014,maxmuscleblast,http://click2hit.com/maxmuscleblast,38,2,36
08:04:2014,maxmusclelean,http://click2hit.com/maxmusclelean,47,48,-1
08:04:2014,maxtrimraspberryketone,http://click2hit.com/maxtrimraspberryketone,107,107,0
08:04:2014,maxxmale,http://click2hit.com/maxxmale,183,183,0
08:04:2014,maxxtest300,http://click2hit.com/maxxtest300,25,27,-2
08:04:2014,miraclegarciniacambogia1300,http://click2hit.com/miraclegarciniacambogia1300,52,53,-1
08:04:2014,miraclegarciniacambogiarx,http://click2hit.com/miraclegarciniacambogiarx,63,68,-5
08:04:2014,miraclephytoceramides,http://click2hit.com/miraclephytoceramides,2183,2209,-26
08:04:2014,miracleraspberryketone,http://click2hit.com/miracleraspberryketone,27,27,0
08:04:2014,mitoslim,http://click2hit.com/mitoslim,749,749,0
08:04:2014,mizulean,http://click2hit.com/mizulean,245,245,0
08:04:2014,musclecorex,http://click2hit.com/musclecorex,514,514,0
08:04:2014,muscleforcex,http://click2hit.com/muscleforcex,89,89,0
08:04:2014,musclekingpro,http://click2hit.com/musclekingpro,303,303,0
08:04:2014,musclemax,http://click2hit.com/musclemax,228,229,-1
08:04:2014,muscleripx,http://click2hit.com/muscleripx,212,215,-3
08:04:2014,musclexedge,http://click2hit.com/musclexedge,526,527,-1
08:04:2014,musclexpro,http://click2hit.com/musclexpro,98,98,0
08:04:2014,musclezx90,http://click2hit.com/musclezx90,2906,2907,-1
08:04:2014,naturalburn,http://click2hit.com/naturalburn,258,258,0
08:04:2014,naturalcleanse,http://click2hit.com/naturalcleanse,812,812,0
08:04:2014,naturalcoloncleanseelite,http://click2hit.com/naturalcoloncleanseelite,322,323,-1
08:04:2014,naturaldiet,http://click2hit.com/naturaldiet,147,147,0
08:04:2014,naturalgarciniacambogiaburn,http://click2hit.com/naturalgarciniacambogiaburn,240,240,0
08:04:2014,naturalgreencleanse,http://click2hit.com/naturalgreencleanse,549,552,-3
08:04:2014,naturalgreencoffeeburn,http://click2hit.com/naturalgreencoffeeburn,423,423,0
08:04:2014,naturalpluscleanse,http://click2hit.com/naturalpluscleanse,129,130,-1
08:04:2014,naturalpurecleanse,http://click2hit.com/naturalpurecleanse,394,394,0
08:04:2014,neucleanseultimate,http://click2hit.com/neucleanseultimate,435,450,-15
08:04:2014,neugarciniacambogia,http://click2hit.com/neugarciniacambogia,16,18,-2
08:04:2014,neuropathysupportformula,http://click2hit.com/neuropathysupportformula,247,253,-6
08:04:2014,newagecleanse,http://click2hit.com/newagecleanse,330,330,0
08:04:2014,newlifecleanse,http://click2hit.com/newlifecleanse,157,158,-1
08:04:2014,nidora,http://click2hit.com/nidora,542,562,-20
08:04:2014,nitricmaxmuscle,http://click2hit.com/nitricmaxmuscle,319,321,-2
08:04:2014,nitricmaxmuscle1,http://click2hit.com/nitricmaxmuscle1,62,62,0
08:04:2014,nitricpower,http://click2hit.com/nitricpower,11,14,-3
08:04:2014,nitroxin,http://click2hit.com/nitroxin,30,37,-7
08:04:2014,nitroxl,http://click2hit.com/nitroxl,282,282,0
08:04:2014,nitroxpro,http://click2hit.com/nitroxpro,6573,6693,-120
08:04:2014,no2explodeextreme,http://click2hit.com/no2explodeextreme,1497,1504,-7
08:04:2014,no2factor,http://click2hit.com/no2factor,330,330,0
08:04:2014,no2maximus,http://click2hit.com/no2maximus,2386,2416,-30
08:04:2014,no2surge,http://click2hit.com/no2surge,261,287,-26
08:04:2014,nuetrim,http://click2hit.com/nuetrim,429,429,0
08:04:2014,nutraburn10,http://click2hit.com/nutraburn10,95,97,-2
08:04:2014,nutranaturalgarciniacambogia,http://click2hit.com/nutranaturalgarciniacambogia,117,118,-1
08:04:2014,nutridiet,http://click2hit.com/nutridiet,1026,1049,-23
08:04:2014,nuvagenic,http://click2hit.com/nuvagenic,197,197,0
08:04:2014,nuvie,http://click2hit.com/nuvie,160,168,-8
08:04:2014,nuvocleanse,http://click2hit.com/nuvocleanse,591,591,0
08:04:2014,nuvoslim,http://click2hit.com/nuvoslim,403,435,-32
08:04:2014,onemoment,http://click2hit.com/onemoment,147,162,-15
08:04:2014,optimalstack,http://click2hit.com/optimalstack,467,468,-1
08:04:2014,organiccleanse,http://click2hit.com/organiccleanse,3,3,0
08:04:2014,organiccleansedetox,http://click2hit.com/organiccleansedetox,63,67,-4
08:04:2014,organicgarciniacambogia,http://click2hit.com/organicgarciniacambogia,195,195,0
08:04:2014,originalgarciniacambogia,http://click2hit.com/originalgarciniacambogia,53,55,-2
08:04:2014,originalyaconextract,http://click2hit.com/originalyaconextract,152,154,-2
08:04:2014,originalyaconsyrup,http://click2hit.com/originalyaconsyrup,57,57,0
08:04:2014,orvigomax,http://click2hit.com/orvigomax,65,77,-12
08:04:2014,ourgreencleanse,http://click2hit.com/ourgreencleanse,147,147,0
08:04:2014,oxygenius,http://click2hit.com/oxygenius,1356,1371,-15
08:04:2014,pelevoni,http://click2hit.com/pelevoni,320,320,0
08:04:2014,platinumgarciniacambogia,http://click2hit.com/platinumgarciniacambogia,356,368,-12
08:04:2014,poshcream,http://click2hit.com/poshcream,25,47,-22
08:04:2014,powermax,http://click2hit.com/powermax,8,11,-3
08:04:2014,powerprecision,http://click2hit.com/powerprecision,118,120,-2
08:04:2014,poweruphealthgarcinia,http://click2hit.com/poweruphealthgarcinia,145,158,-13
08:04:2014,premiermangocleanse,http://click2hit.com/premiermangocleanse,204,204,0
08:04:2014,premiumgarciniacambogiaslim,http://click2hit.com/premiumgarciniacambogiaslim,120,137,-17
08:04:2014,premiumgreencoffeebean,http://click2hit.com/premiumgreencoffeebean,207,208,-1
08:04:2014,procollagen,http://click2hit.com/procollagen,266,267,-1
08:04:2014,procoloncleanse,http://click2hit.com/procoloncleanse,168,168,0
08:04:2014,prodermagenix,http://click2hit.com/prodermagenix,188,188,0
08:04:2014,prodermagenixplus,http://click2hit.com/prodermagenixplus,257,257,0
08:04:2014,progain350,http://click2hit.com/progain350,3,3,0
08:04:2014,prolong,http://click2hit.com/prolong,618,659,-41
08:04:2014,prolongz,http://click2hit.com/prolongz,453,463,-10
08:04:2014,promusclecomplex,http://click2hit.com/promusclecomplex,539,541,-2
08:04:2014,pronutragarcinia,http://click2hit.com/pronutragarcinia,55,55,0
08:04:2014,protrim,http://click2hit.com/protrim,1046,1048,-2
08:04:2014,purafit,http://click2hit.com/purafit,364,368,-4
08:04:2014,puragreencoffee,http://click2hit.com/puragreencoffee,288,288,0
08:04:2014,pureberrymax,http://click2hit.com/pureberrymax,268,269,-1
08:04:2014,purebiodiet,http://click2hit.com/purebiodiet,648,650,-2
08:04:2014,purecambogiaultra,http://click2hit.com/purecambogiaultra,201,211,-10
08:04:2014,purecambogiaultra-1,http://click2hit.com/purecambogiaultra-1,594,598,-4
08:04:2014,purecambogiaultra2,http://click2hit.com/purecambogiaultra2,176,178,-2
08:04:2014,purecleanse,http://click2hit.com/purecleanse,500,500,0
08:04:2014,purecleansemax,http://click2hit.com/purecleansemax,235,4,231
08:04:2014,purecolocleanse,http://click2hit.com/purecolocleanse,265,267,-2
08:04:2014,purecoloncleanser,http://click2hit.com/purecoloncleanser,1555,1555,0
08:04:2014,puregarciniacambogia,http://click2hit.com/puregarciniacambogia,195,195,0
08:04:2014,puregarciniacambogia-1,http://click2hit.com/puregarciniacambogia-1,7682,7792,-110
08:04:2014,puregarciniacambogiaburn,http://click2hit.com/puregarciniacambogiaburn,2327,2329,-2
08:04:2014,puregarciniacambogiaplus,http://click2hit.com/puregarciniacambogiaplus,375,377,-2
08:04:2014,puregarciniacambogiapremium,http://click2hit.com/puregarciniacambogiapremium,1226,1233,-7
08:04:2014,puregarciniacambogiaslim,http://click2hit.com/puregarciniacambogiaslim,891,893,-2
08:04:2014,puregarciniacambogiaslimsystem,http://click2hit.com/puregarciniacambogiaslimsystem,252,252,0
08:04:2014,puregarciniacanada,http://click2hit.com/puregarciniacanada,55,56,-1
08:04:2014,puregarciniaelite,http://click2hit.com/puregarciniaelite,31,31,0
08:04:2014,puregarciniaslim,http://click2hit.com/puregarciniaslim,345,173,172
08:04:2014,puregarciniaultra,http://click2hit.com/puregarciniaultra,522,533,-11
08:04:2014,puregarciniaultra-1,http://click2hit.com/puregarciniaultra-1,134,134,0
08:04:2014,puregreencoffee,http://click2hit.com/puregreencoffee,420,420,0
08:04:2014,puregreencoffeebeanplus,http://click2hit.com/puregreencoffeebeanplus,17,27,-10
08:04:2014,purelifecleanse1,http://click2hit.com/purelifecleanse1,400,480,-80
08:04:2014,purenitrate,http://click2hit.com/purenitrate,81,94,-13
08:04:2014,purenitromax,http://click2hit.com/purenitromax,491,491,0
08:04:2014,purensa,http://click2hit.com/purensa,1661,1666,-5
08:04:2014,pureraspberryketonepremium,http://click2hit.com/pureraspberryketonepremium,235,239,-4
08:04:2014,puressance,http://click2hit.com/puressance,124,124,0
08:04:2014,purestgarciniacambogia,http://click2hit.com/purestgarciniacambogia,19,19,0
08:04:2014,pureyaconsyrupextract,http://click2hit.com/pureyaconsyrupextract,255,255,0
08:04:2014,pureyaconsyrupplus,http://click2hit.com/pureyaconsyrupplus,149,149,0
08:04:2014,pureyaconxt,http://click2hit.com/pureyaconxt,73,75,-2
08:04:2014,px800greencoffee,http://click2hit.com/px800greencoffee,57,57,0
08:04:2014,quickgreencoffee,http://click2hit.com/quickgreencoffee,395,396,-1
08:04:2014,raspberryketonefresh,http://click2hit.com/raspberryketonefresh,1061,1066,-5
08:04:2014,raspberryketoneproslim,http://click2hit.com/raspberryketoneproslim,311,313,-2
08:04:2014,raspberryketones,http://click2hit.com/raspberryketones,321,323,-2
08:04:2014,raspberryslimplus,http://click2hit.com/raspberryslimplus,178,178,0
08:04:2014,raspberrytones,http://click2hit.com/raspberrytones,359,359,0
08:04:2014,raspberrytrim,http://click2hit.com/raspberrytrim,149,154,-5
08:04:2014,raspberryultraketone,http://click2hit.com/raspberryultraketone,199,200,-1
08:04:2014,rawburn,http://click2hit.com/rawburn,145,145,0
08:04:2014,regularx,http://click2hit.com/regularx,97,115,-18
08:04:2014,rejouvance,http://click2hit.com/rejouvance,480,482,-2
08:04:2014,rejuvaglow,http://click2hit.com/rejuvaglow,65,65,0
08:04:2014,rejuvalash,http://click2hit.com/rejuvalash,255,256,-1
08:04:2014,rejuvalskin,http://click2hit.com/rejuvalskin,29,34,-5
08:04:2014,rejuvenex,http://click2hit.com/rejuvenex,352,352,0
08:04:2014,reliftadvanced,http://click2hit.com/reliftadvanced,268,269,-1
08:04:2014,renique,http://click2hit.com/renique,663,674,-11
08:04:2014,restore,http://click2hit.com/restore,85,85,0
08:04:2014,revitol,http://click2hit.com/revitol,62,63,-1
08:04:2014,revivagenix,http://click2hit.com/revivagenix,227,227,0
08:04:2014,revivasol,http://click2hit.com/revivasol,2238,2240,-2
08:04:2014,revolyn,http://click2hit.com/revolyn,213,213,0
08:04:2014,revoreplex,http://click2hit.com/revoreplex,4,207,-203
08:04:2014,rippedmusclex,http://click2hit.com/rippedmusclex,12,12,0
08:04:2014,rvtl,http://click2hit.com/rvtl,1894,1900,-6
08:04:2014,saphireecig,http://click2hit.com/saphireecig,592,592,0
08:04:2014,secretbodybulk,http://click2hit.com/secretbodybulk,306,307,-1
08:04:2014,secretgarciniacambogia,http://click2hit.com/secretgarciniacambogia,249,249,0
08:04:2014,secretlift,http://click2hit.com/secretlift,10,10,0
08:04:2014,sensa,http://click2hit.com/sensa,131,132,-1
08:04:2014,simplycleanse,http://click2hit.com/simplycleanse,234,235,-1
08:04:2014,simplygarciniacambogia,http://click2hit.com/simplygarciniacambogia,431,433,-2
08:04:2014,simplygreencoffee,http://click2hit.com/simplygreencoffee,328,330,-2
08:04:2014,skinliftadvanced,http://click2hit.com/skinliftadvanced,221,222,-1
08:04:2014,skinnyfiber,http://click2hit.com/skinnyfiber,397,397,0
08:04:2014,slendera-1,http://click2hit.com/slendera-1,39,39,0
08:04:2014,slendera-sab,http://click2hit.com/slendera-sab,68,70,-2
08:04:2014,slimberrymax,http://click2hit.com/slimberrymax,256,258,-2
08:04:2014,slimbodycleanse,http://click2hit.com/slimbodycleanse,3101,3110,-9
08:04:2014,slimbodyketones,http://click2hit.com/slimbodyketones,120,134,-14
08:04:2014,slimcleanseplus,http://click2hit.com/slimcleanseplus,110,110,0
08:04:2014,slimlean,http://click2hit.com/slimlean,1034,1035,-1
08:04:2014,slimnogym,http://click2hit.com/slimnogym,222,223,-1
08:04:2014,slimtrimpm,http://click2hit.com/slimtrimpm,38,48,-10
08:04:2014,smileprodirect,http://click2hit.com/smileprodirect,2902,2930,-28
08:04:2014,solpria,http://click2hit.com/solpria,1080,1084,-4
08:04:2014,sparkwhitening,http://click2hit.com/sparkwhitening,1603,1603,0
08:04:2014,strawberrygarciniacambogia,http://click2hit.com/strawberrygarciniacambogia,435,441,-6
08:04:2014,superbetaprostate,http://click2hit.com/superbetaprostate,152,152,0
08:04:2014,supercoloncleanse1800,http://click2hit.com/supercoloncleanse1800,289,289,0
08:04:2014,supergarciniacambogia,http://click2hit.com/supergarciniacambogia,980,983,-3
08:04:2014,superiorvelvet,http://click2hit.com/superiorvelvet,465,473,-8
08:04:2014,superketoneplus,http://click2hit.com/superketoneplus,4015,4052,-37
08:04:2014,superlean,http://click2hit.com/superlean,200,200,0
08:04:2014,superleancoloncleanse,http://click2hit.com/superleancoloncleanse,1331,1338,-7
08:04:2014,supertestoboost,http://click2hit.com/supertestoboost,131,133,-2
08:04:2014,superyaconsyrup1000,http://click2hit.com/superyaconsyrup1000,23,24,-1
08:04:2014,supracleanse350,http://click2hit.com/supracleanse350,612,665,-53
08:04:2014,supremeantler,http://click2hit.com/supremeantler,129,130,-1
08:04:2014,svelme,http://click2hit.com/svelme,46,46,0
08:04:2014,swolecreatinemuscle,http://click2hit.com/swolecreatinemuscle,186,186,0
08:04:2014,syneocell,http://click2hit.com/syneocell,188,188,0
08:04:2014,tadvance,http://click2hit.com/tadvance,469,470,-1
08:04:2014,testabolancyp,http://click2hit.com/testabolancyp,343,343,0
08:04:2014,testocoreadvanced,http://click2hit.com/testocoreadvanced,281,296,-15
08:04:2014,testoforceedge,http://click2hit.com/testoforceedge,477,478,-1
08:04:2014,testoforcex,http://click2hit.com/testoforcex,293,294,-1
08:04:2014,testolimit,http://click2hit.com/testolimit,38,39,-1
08:04:2014,testomax,http://click2hit.com/testomax,274,275,-1
08:04:2014,testoril,http://click2hit.com/testoril,522,522,0
08:04:2014,testorushrx,http://click2hit.com/testorushrx,400,413,-13
08:04:2014,testoupmax,http://click2hit.com/testoupmax,95,105,-10
08:04:2014,testrx360,http://click2hit.com/testrx360,333,333,0
08:04:2014,testtoforcextreme,http://click2hit.com/testtoforcextreme,386,387,-1
08:04:2014,testx180,http://click2hit.com/testx180,1400,1408,-8
08:04:2014,thermoblackx,http://click2hit.com/thermoblackx,139,141,-2
08:04:2014,thermoextreme1,http://click2hit.com/thermoextreme1,570,570,0
08:04:2014,thermofactorx,http://click2hit.com/thermofactorx,815,817,-2
08:04:2014,thermosculptpro,http://click2hit.com/thermosculptpro,322,322,0
08:04:2014,titaniumprox,http://click2hit.com/titaniumprox,787,791,-4
08:04:2014,tlevelboost,http://click2hit.com/tlevelboost,63,64,-1
08:04:2014,tonaderm,http://click2hit.com/tonaderm,200,202,-2
08:04:2014,totalcleansecomplete,http://click2hit.com/totalcleansecomplete,369,377,-8
08:04:2014,trigx2,http://click2hit.com/trigx2,330,330,0
08:04:2014,trimextrin,http://click2hit.com/trimextrin,172,0,172
08:04:2014,truburnplus,http://click2hit.com/truburnplus,27,27,0
08:04:2014,truecleansecomplete,http://click2hit.com/truecleansecomplete,168,193,-25
08:04:2014,turbofrce,http://click2hit.com/turbofrce,419,422,-3
08:04:2014,ultracelebdiet,http://click2hit.com/ultracelebdiet,359,361,-2
08:04:2014,ultracleansepure,http://click2hit.com/ultracleansepure,385,418,-33
08:04:2014,ultracoloncleanse,http://click2hit.com/ultracoloncleanse,44,44,0
08:04:2014,ultrafinesse,http://click2hit.com/ultrafinesse,84,84,0
08:04:2014,ultragarciniacambogia,http://click2hit.com/ultragarciniacambogia,51,52,-1
08:04:2014,ultramaxtestosterone,http://click2hit.com/ultramaxtestosterone,227,227,0
08:04:2014,ultraslim,http://click2hit.com/ultraslim,188,189,-1
08:04:2014,umoris,http://click2hit.com/umoris,400,404,-4
08:04:2014,vantage,http://click2hit.com/vantage,5,5,0
08:04:2014,vapexecig,http://click2hit.com/vapexecig,338,342,-4
08:04:2014,vimaxdetox,http://click2hit.com/vimaxdetox,883,885,-2
08:04:2014,virilityex,http://click2hit.com/virilityex,202,202,0
08:04:2014,vitaberryburn,http://click2hit.com/vitaberryburn,371,371,0
08:04:2014,vitaberrytrim,http://click2hit.com/vitaberrytrim,1804,1804,0
08:04:2014,vitacleanse,http://click2hit.com/vitacleanse,4474,4518,-44
08:04:2014,vitaketone,http://click2hit.com/vitaketone,936,944,-8
08:04:2014,vitalcleanse,http://click2hit.com/vitalcleanse,181,181,0
08:04:2014,vitalcleansecomplete,http://click2hit.com/vitalcleansecomplete,752,754,-2
08:04:2014,vitalifedetox,http://click2hit.com/vitalifedetox,742,742,0
08:04:2014,vitalikortest,http://click2hit.com/vitalikortest,592,599,-7
08:04:2014,vitalipo,http://click2hit.com/vitalipo,122,122,0
08:04:2014,vitalitygreencoffee,http://click2hit.com/vitalitygreencoffee,197,197,0
08:04:2014,vitamaxgarciniacambogia,http://click2hit.com/vitamaxgarciniacambogia,1759,1783,-24
08:04:2014,vyalis,http://click2hit.com/vyalis,232,232,0
08:04:2014,wrinklerewind,http://click2hit.com/wrinklerewind,5681,5716,-35
08:04:2014,xmrecovery,http://click2hit.com/xmrecovery,144,147,-3
08:04:2014,xtremegarciniacambogia,http://click2hit.com/xtremegarciniacambogia,483,484,-1
08:04:2014,xtremenitro,http://click2hit.com/xtremenitro,22,32,-10
08:04:2014,xtremetestosteronebooster,http://click2hit.com/xtremetestosteronebooster,363,364,-1
08:04:2014,yaconmolasses,http://click2hit.com/yaconmolasses,80,80,0
08:04:2014,yaconrootmax,http://click2hit.com/yaconrootmax,1095,1179,-84
08:04:2014,yaconsyrupdirect,http://click2hit.com/yaconsyrupdirect,214,215,-1
08:04:2014,yolosleep,http://click2hit.com/yolosleep,213,213,0
08:04:2014,youthkitantiaging,http://click2hit.com/youthkitantiaging,197,198,-1
08:04:2014,zenacose,http://click2hit.com/zenacose,162,163,-1
08:04:2014,zenscleanse,http://click2hit.com/zenscleanse,2602,2613,-11
08:04:2014,zinncollection,http://click2hit.com/zinncollection,179,180,-1
08:04:2014,zolyria,http://click2hit.com/zolyria,486,491,-5
08:04:2014,zyloslim,http://click2hit.com/zyloslim,3751,3756,-5
08:04:2014,zymbiotix,http://click2hit.com/zymbiotix,1253,1267,-14
