dt_today,sitetitle,sitelink,pre_click,new_clicks,difrnce
11:04:2014,5stargarciniacambogia,http://click2hit.com/5stargarciniacambogia,87,87,0
11:04:2014,Adrenalast,http://click2hit.com/Adrenalast,548,549,-1
11:04:2014,Anataflex,http://click2hit.com/Anataflex,1302,1306,-4
11:04:2014,Diabetix,http://click2hit.com/Diabetix,725,726,-1
11:04:2014,Equinox,http://click2hit.com/Equinox,8758,8785,-27
11:04:2014,LuxeCoat,http://click2hit.com/LuxeCoat,415,416,-1
11:04:2014,NOX360,http://click2hit.com/NOX360,53,54,-1
11:04:2014,Prescopodene,http://click2hit.com/Prescopodene,1357,1357,0
11:04:2014,Puregarciniaslim,http://click2hit.com/Puregarciniaslim,173,345,-172
11:04:2014,RevoReplex,http://click2hit.com/RevoReplex,207,4,203
11:04:2014,absoluteraspberryketone,http://click2hit.com/absoluteraspberryketone,10,10,0
11:04:2014,acaiberrypuremax,http://click2hit.com/acaiberrypuremax,179,180,-1
11:04:2014,actionprowhite,http://click2hit.com/actionprowhite,150,178,-28
11:04:2014,activedetoxcleanse,http://click2hit.com/activedetoxcleanse,35,36,-1
11:04:2014,activeraspberryketone,http://click2hit.com/activeraspberryketone,132,145,-13
11:04:2014,advancedgarciniacambogia,http://click2hit.com/advancedgarciniacambogia,779,779,0
11:04:2014,advancedpuregarcinia,http://click2hit.com/advancedpuregarcinia,553,555,-2
11:04:2014,advancedtest,http://click2hit.com/advancedtest,572,573,-1
11:04:2014,advancedtrimgreencoffee,http://click2hit.com/advancedtrimgreencoffee,1685,1690,-5
11:04:2014,africanmangopremier,http://click2hit.com/africanmangopremier,746,746,0
11:04:2014,agelesshealthsolution,http://click2hit.com/agelesshealthsolution,127,128,-1
11:04:2014,alleureantiagingcream,http://click2hit.com/alleureantiagingcream,286,302,-16
11:04:2014,alleureeyeserum,http://click2hit.com/alleureeyeserum,329,346,-17
11:04:2014,aloeferoxcleanse,http://click2hit.com/aloeferoxcleanse,17,25,-8
11:04:2014,aloeveracleanse,http://click2hit.com/aloeveracleanse,654,658,-4
11:04:2014,alore,http://click2hit.com/alore,3952,3977,-25
11:04:2014,alphacuthd,http://click2hit.com/alphacuthd,60,60,0
11:04:2014,alphagenix,http://click2hit.com/alphagenix,73,87,-14
11:04:2014,alphamale,http://click2hit.com/alphamale,200,201,-1
11:04:2014,alphamax1,http://click2hit.com/alphamax1,254,255,-1
11:04:2014,amacari,http://click2hit.com/amacari,154,154,0
11:04:2014,amazingcleanse,http://click2hit.com/amazingcleanse,2,2,0
11:04:2014,ambitrimrx,http://click2hit.com/ambitrimrx,776,776,0
11:04:2014,amino,http://click2hit.com/amino,1271,1272,-1
11:04:2014,andromale,http://click2hit.com/andromale,536,539,-3
11:04:2014,anoradrol,http://click2hit.com/anoradrol,86,86,0
11:04:2014,aussiegarciniacambogia,http://click2hit.com/aussiegarciniacambogia,166,166,0
11:04:2014,authenticgarciniacambogia,http://click2hit.com/authenticgarciniacambogia,81,83,-2
11:04:2014,beaute,http://click2hit.com/beaute,649,649,0
11:04:2014,bellaathome,http://click2hit.com/bellaathome,1771,1780,-9
11:04:2014,bellapure,http://click2hit.com/bellapure,1783,1798,-15
11:04:2014,bellecomplex,http://click2hit.com/bellecomplex,657,659,-2
11:04:2014,berryherbalcleanse,http://click2hit.com/berryherbalcleanse,572,572,0
11:04:2014,berrythingarciniacambogia,http://click2hit.com/berrythingarciniacambogia,540,540,0
11:04:2014,betaalalinemax,http://click2hit.com/betaalalinemax,570,570,0
11:04:2014,betaboost,http://click2hit.com/betaboost,108,108,0
11:04:2014,betaforce,http://click2hit.com/betaforce,655,656,-1
11:04:2014,beyondraspberryketone,http://click2hit.com/beyondraspberryketone,2101,2101,0
11:04:2014,biocareslimplus,http://click2hit.com/biocareslimplus,314,314,0
11:04:2014,biocarexl,http://click2hit.com/biocarexl,327,328,-1
11:04:2014,biogeniste,http://click2hit.com/biogeniste,449,453,-4
11:04:2014,blackbullmaleenhancement,http://click2hit.com/blackbullmaleenhancement,1458,1459,-1
11:04:2014,blackdiamond,http://click2hit.com/blackdiamond,530,541,-11
11:04:2014,blacklineelite,http://click2hit.com/blacklineelite,1553,1559,-6
11:04:2014,blastxl,http://click2hit.com/blastxl,144,144,0
11:04:2014,blizzadwhite,http://click2hit.com/blizzadwhite,36,45,-9
11:04:2014,bluemagicplus,http://click2hit.com/bluemagicplus,877,879,-2
11:04:2014,bodyfuelxs,http://click2hit.com/bodyfuelxs,90,90,0
11:04:2014,brandnew,http://click2hit.com/brandnew,351,351,0
11:04:2014,brandnewbooty,http://click2hit.com/brandnewbooty,775,777,-2
11:04:2014,cafevertextraminceur,http://click2hit.com/cafevertextraminceur,2569,2641,-72
11:04:2014,carbuloss,http://click2hit.com/carbuloss,386,388,-2
11:04:2014,celebritybodynow,http://click2hit.com/celebritybodynow,423,423,0
11:04:2014,celebrityweightlosskit,http://click2hit.com/celebrityweightlosskit,361,361,0
11:04:2014,cellanafricanmango,http://click2hit.com/cellanafricanmango,2322,2369,-47
11:04:2014,cellogicaskin,http://click2hit.com/cellogicaskin,193,197,-4
11:04:2014,cenaless,http://click2hit.com/cenaless,75,75,0
11:04:2014,cenaslim,http://click2hit.com/cenaslim,395,396,-1
11:04:2014,cleandetox,http://click2hit.com/cleandetox,273,274,-1
11:04:2014,cleansecatalystplus,http://click2hit.com/cleansecatalystplus,3352,3363,-11
11:04:2014,cleanseultimo,http://click2hit.com/cleanseultimo,1421,1423,-2
11:04:2014,cocogeniceyeserum,http://click2hit.com/cocogeniceyeserum,13,17,-4
11:04:2014,coffeecleansemax,http://click2hit.com/coffeecleansemax,395,397,-2
11:04:2014,coffeepurecleanse,http://click2hit.com/coffeepurecleanse,63,69,-6
11:04:2014,coleanse,http://click2hit.com/coleanse,2109,2115,-6
11:04:2014,collagen,http://click2hit.com/collagen,27,31,-4
11:04:2014,collagenfaceserum,http://click2hit.com/collagenfaceserum,50,52,-2
11:04:2014,colodetox,http://click2hit.com/colodetox,532,532,0
11:04:2014,colodetoxplus,http://click2hit.com/colodetoxplus,93,93,0
11:04:2014,coloncleanse1300,http://click2hit.com/coloncleanse1300,287,287,0
11:04:2014,coloncleansecomplete,http://click2hit.com/coloncleansecomplete,1302,1305,-3
11:04:2014,coloncleansetotal,http://click2hit.com/coloncleansetotal,770,775,-5
11:04:2014,colondetoxpro,http://click2hit.com/colondetoxpro,50,53,-3
11:04:2014,colonpurecleanse,http://click2hit.com/colonpurecleanse,426,429,-3
11:04:2014,colothin,http://click2hit.com/colothin,194,195,-1
11:04:2014,columbiangreencoffeebean,http://click2hit.com/columbiangreencoffeebean,787,790,-3
11:04:2014,combogiaplus,http://click2hit.com/combogiaplus,331,331,0
11:04:2014,completecoffeecleanse,http://click2hit.com/completecoffeecleanse,400,400,0
11:04:2014,complexiderm,http://click2hit.com/complexiderm,187,187,0
11:04:2014,cosimarevival,http://click2hit.com/cosimarevival,184,184,0
11:04:2014,cosmitone,http://click2hit.com/cosmitone,1335,1336,-1
11:04:2014,csorex,http://click2hit.com/csorex,108,108,0
11:04:2014,curcovia,http://click2hit.com/curcovia,427,427,0
11:04:2014,cutiecurves,http://click2hit.com/cutiecurves,246,246,0
11:04:2014,cytotrim,http://click2hit.com/cytotrim,5,5,0
11:04:2014,dailyeyerestoration,http://click2hit.com/dailyeyerestoration,151,158,-7
11:04:2014,dellure,http://click2hit.com/dellure,119,119,0
11:04:2014,dellurecollagen,http://click2hit.com/dellurecollagen,570,571,-1
11:04:2014,dermafirm,http://click2hit.com/dermafirm,762,765,-3
11:04:2014,dermajuvenate,http://click2hit.com/dermajuvenate,2361,2373,-12
11:04:2014,dermalift,http://click2hit.com/dermalift,235,235,0
11:04:2014,dermallo,http://click2hit.com/dermallo,269,270,-1
11:04:2014,dermalmeds,http://click2hit.com/dermalmeds,446,448,-2
11:04:2014,dermangelie,http://click2hit.com/dermangelie,156,156,0
11:04:2014,derminelift,http://click2hit.com/derminelift,405,405,0
11:04:2014,dermology,http://click2hit.com/dermology,45,46,-1
11:04:2014,detoxmax,http://click2hit.com/detoxmax,61,61,0
11:04:2014,dietultimo,http://click2hit.com/dietultimo,2542,2549,-7
11:04:2014,digestItcoloncleanse,http://click2hit.com/digestItcoloncleanse,66,67,-1
11:04:2014,duplicellp199,http://click2hit.com/duplicellp199,48,56,-8
11:04:2014,duplicellp199facetherapy,http://click2hit.com/duplicellp199facetherapy,52,56,-4
11:04:2014,ecoflex,http://click2hit.com/ecoflex,128,130,-2
11:04:2014,electravx,http://click2hit.com/electravx,180,182,-2
11:04:2014,elevategf,http://click2hit.com/elevategf,269,269,0
11:04:2014,elite360,http://click2hit.com/elite360,70,71,-1
11:04:2014,elliskin,http://click2hit.com/elliskin,511,512,-1
11:04:2014,endorev,http://click2hit.com/endorev,463,464,-1
11:04:2014,ephedrix,http://click2hit.com/ephedrix,229,229,0
11:04:2014,equivita,http://click2hit.com/equivita,7927,7956,-29
11:04:2014,essentialdetox,http://click2hit.com/essentialdetox,431,432,-1
11:04:2014,extagen,http://click2hit.com/extagen,338,340,-2
11:04:2014,extremefx,http://click2hit.com/extremefx,350,351,-1
11:04:2014,eyeluminous,http://click2hit.com/eyeluminous,693,718,-25
11:04:2014,fembalance,http://click2hit.com/fembalance,362,365,-3
11:04:2014,firmativ,http://click2hit.com/firmativ,889,914,-25
11:04:2014,flawlessbeauty,http://click2hit.com/flawlessbeauty,110,110,0
11:04:2014,flexwell,http://click2hit.com/flexwell,103,103,0
11:04:2014,forceeffect,http://click2hit.com/forceeffect,372,406,-34
11:04:2014,formularezvmagic,http://click2hit.com/formularezvmagic,231,231,0
11:04:2014,fortdietmax,http://click2hit.com/fortdietmax,82,82,0
11:04:2014,fortmaxdiet,http://click2hit.com/fortmaxdiet,74,74,0
11:04:2014,garciniaberrythin,http://click2hit.com/garciniaberrythin,479,480,-1
11:04:2014,garciniacambogia1300,http://click2hit.com/garciniacambogia1300,662,664,-2
11:04:2014,garciniacambogia360,http://click2hit.com/garciniacambogia360,23,24,-1
11:04:2014,garciniacambogia500,http://click2hit.com/garciniacambogia500,3,3,0
11:04:2014,garciniacambogiablast,http://click2hit.com/garciniacambogiablast,767,776,-9
11:04:2014,garciniacambogiaburn,http://click2hit.com/garciniacambogiaburn,98,100,-2
11:04:2014,garciniacambogiacomplex,http://click2hit.com/garciniacambogiacomplex,333,334,-1
11:04:2014,garciniacambogiaextract,http://click2hit.com/garciniacambogiaextract,48,48,0
11:04:2014,garciniacambogiafit1300,http://click2hit.com/garciniacambogiafit1300,149,151,-2
11:04:2014,garciniacambogiaformula,http://click2hit.com/garciniacambogiaformula,41,42,-1
11:04:2014,garciniacambogiahca,http://click2hit.com/garciniacambogiahca,4,5,-1
11:04:2014,garciniacambogiaplus,http://click2hit.com/garciniacambogiaplus,1135,1135,0
11:04:2014,garciniacambogiapro,http://click2hit.com/garciniacambogiapro,21,21,0
11:04:2014,garciniacambogiaselect,http://click2hit.com/garciniacambogiaselect,491,492,-1
11:04:2014,garciniacambogiaslimfast,http://click2hit.com/garciniacambogiaslimfast,1817,1824,-7
11:04:2014,garciniacambogiaslimsystem,http://click2hit.com/garciniacambogiaslimsystem,1133,1136,-3
11:04:2014,garciniacambogiaxt,http://click2hit.com/garciniacambogiaxt,189,192,-3
11:04:2014,garciniacambogiaz,http://click2hit.com/garciniacambogiaz,3,4,-1
11:04:2014,garciniacombogiasupreme,http://click2hit.com/garciniacombogiasupreme,24,24,0
11:04:2014,garciniadietmax,http://click2hit.com/garciniadietmax,341,343,-2
11:04:2014,garciniaextractplus,http://click2hit.com/garciniaextractplus,233,234,-1
11:04:2014,garciniaforte,http://click2hit.com/garciniaforte,4,4,0
11:04:2014,garciniahca,http://click2hit.com/garciniahca,143,144,-1
11:04:2014,garciniahcapremium,http://click2hit.com/garciniahcapremium,109,111,-2
11:04:2014,garciniaplus,http://click2hit.com/garciniaplus,1991,1995,-4
11:04:2014,garciniasuperdiet,http://click2hit.com/garciniasuperdiet,174,174,0
11:04:2014,garciniawonder,http://click2hit.com/garciniawonder,10,12,-2
11:04:2014,garciniawow,http://click2hit.com/garciniawow,100,102,-2
11:04:2014,garciniaxslim,http://click2hit.com/garciniaxslim,571,587,-16
11:04:2014,gc180xt,http://click2hit.com/gc180xt,579,586,-7
11:04:2014,gcbmaxgreencoffee,http://click2hit.com/gcbmaxgreencoffee,345,346,-1
11:04:2014,gcfitsgarcinia,http://click2hit.com/gcfitsgarcinia,6,6,0
11:04:2014,gcxsdiet,http://click2hit.com/gcxsdiet,54,55,-1
11:04:2014,genesis,http://click2hit.com/genesis,43,43,0
11:04:2014,gogiberryburn,http://click2hit.com/gogiberryburn,43,52,-9
11:04:2014,gojiactives,http://click2hit.com/gojiactives,1514,1521,-7
11:04:2014,gojiadvance,http://click2hit.com/gojiadvance,416,420,-4
11:04:2014,gojimax,http://click2hit.com/gojimax,254,259,-5
11:04:2014,gojislim,http://click2hit.com/gojislim,20289,20313,-24
11:04:2014,govapor,http://click2hit.com/govapor,113,121,-8
11:04:2014,greencoffeebeanthin,http://click2hit.com/greencoffeebeanthin,289,289,0
11:04:2014,greencoffeebody,http://click2hit.com/greencoffeebody,419,419,0
11:04:2014,greencoffeecleanse,http://click2hit.com/greencoffeecleanse,19,20,-1
11:04:2014,greencoffeecleanse1,http://click2hit.com/greencoffeecleanse1,29,29,0
11:04:2014,greencoffeecleanses,http://click2hit.com/greencoffeecleanses,901,918,-17
11:04:2014,greencoffeeextraslim,http://click2hit.com/greencoffeeextraslim,273,275,-2
11:04:2014,greencoffeefatburn,http://click2hit.com/greencoffeefatburn,1578,1580,-2
11:04:2014,greencoffeenaxx,http://click2hit.com/greencoffeenaxx,195,197,-2
11:04:2014,greencoffeeplus,http://click2hit.com/greencoffeeplus,104,104,0
11:04:2014,greencoffeeprogram,http://click2hit.com/greencoffeeprogram,62,62,0
11:04:2014,greencoffeerevolution,http://click2hit.com/greencoffeerevolution,26,28,-2
11:04:2014,greencoffeespeedslim,http://click2hit.com/greencoffeespeedslim,1474,1497,-23
11:04:2014,greencoffeesupreme,http://click2hit.com/greencoffeesupreme,351,352,-1
11:04:2014,greencoffeesupremecleanse,http://click2hit.com/greencoffeesupremecleanse,120,120,0
11:04:2014,greendetoxpatch,http://click2hit.com/greendetoxpatch,285,285,0
11:04:2014,greenleancoffeebean,http://click2hit.com/greenleancoffeebean,210,211,-1
11:04:2014,greentonepromuscle,http://click2hit.com/greentonepromuscle,214,215,-1
11:04:2014,growxl,http://click2hit.com/growxl,2736,2737,-1
11:04:2014,hairgenesis,http://click2hit.com/hairgenesis,80,80,0
11:04:2014,hardknight,http://click2hit.com/hardknight,1448,1451,-3
11:04:2014,hardknight-1,http://click2hit.com/hardknight-1,84,84,0
11:04:2014,hawaiislim,http://click2hit.com/hawaiislim,146,146,0
11:04:2014,healthycleanse,http://click2hit.com/healthycleanse,518,519,-1
11:04:2014,heboost,http://click2hit.com/heboost,235,236,-1
11:04:2014,hghfuel,http://click2hit.com/hghfuel,28,28,0
11:04:2014,hghpro,http://click2hit.com/hghpro,36,41,-5
11:04:2014,hghxl,http://click2hit.com/hghxl,140,140,0
11:04:2014,hight,http://click2hit.com/hight,325,325,0
11:04:2014,hspactives,http://click2hit.com/hspactives,2164,2167,-3
11:04:2014,htrush,http://click2hit.com/htrush,320,325,-5
11:04:2014,hydradiance,http://click2hit.com/hydradiance,560,570,-10
11:04:2014,hydrafirm,http://click2hit.com/hydrafirm,260,260,0
11:04:2014,hydravella,http://click2hit.com/hydravella,232,233,-1
11:04:2014,hydroface,http://click2hit.com/hydroface,619,619,0
11:04:2014,hydroxatone90,http://click2hit.com/hydroxatone90,325,327,-2
11:04:2014,hydroxatonebbcream,http://click2hit.com/hydroxatonebbcream,74,74,0
11:04:2014,idolize,http://click2hit.com/idolize,168,190,-22
11:04:2014,instaleanketones,http://click2hit.com/instaleanketones,705,706,-1
11:04:2014,instantderma,http://click2hit.com/instantderma,185,185,0
11:04:2014,instantlift,http://click2hit.com/instantlift,474,475,-1
11:04:2014,juvalife,http://click2hit.com/juvalife,95,95,0
11:04:2014,juvamend,http://click2hit.com/juvamend,8,8,0
11:04:2014,juvesiio,http://click2hit.com/juvesiio,57,57,0
11:04:2014,ketoneadvanced,http://click2hit.com/ketoneadvanced,16,20,-4
11:04:2014,ketonepremium,http://click2hit.com/ketonepremium,530,530,0
11:04:2014,kollagen,http://click2hit.com/kollagen,83,84,-1
11:04:2014,l-carnitineplus,http://click2hit.com/l-carnitineplus,148,149,-1
11:04:2014,ladermanique,http://click2hit.com/ladermanique,1736,1743,-7
11:04:2014,larginineplus,http://click2hit.com/larginineplus,30,30,0
11:04:2014,leanmusclex,http://click2hit.com/leanmusclex,9,9,0
11:04:2014,leptizin,http://click2hit.com/leptizin,104,106,-2
11:04:2014,lifecell,http://click2hit.com/lifecell,140,141,-1
11:04:2014,liftandglowpro,http://click2hit.com/liftandglowpro,36,37,-1
11:04:2014,liftderma,http://click2hit.com/liftderma,768,772,-4
11:04:2014,liftserumpro,http://click2hit.com/liftserumpro,56,56,0
11:04:2014,liftvapor,http://click2hit.com/liftvapor,895,896,-1
11:04:2014,lipo13,http://click2hit.com/lipo13,1071,1116,-45
11:04:2014,lipog3,http://click2hit.com/lipog3,609,636,-27
11:04:2014,liposlim,http://click2hit.com/liposlim,212,212,0
11:04:2014,lisocleanse,http://click2hit.com/lisocleanse,274,308,-34
11:04:2014,lorelia,http://click2hit.com/lorelia,2154,2165,-11
11:04:2014,lumeraeyeserum,http://click2hit.com/lumeraeyeserum,2274,2284,-10
11:04:2014,luminant,http://click2hit.com/luminant,397,397,0
11:04:2014,luminantskin,http://click2hit.com/luminantskin,415,416,-1
11:04:2014,luminique,http://click2hit.com/luminique,86,87,-1
11:04:2014,luministeyegel,http://click2hit.com/luministeyegel,210,210,0
11:04:2014,lunarsleep,http://click2hit.com/lunarsleep,292,302,-10
11:04:2014,lunathin,http://click2hit.com/lunathin,142,143,-1
11:04:2014,lxwpro-t,http://click2hit.com/lxwpro-t,35,39,-4
11:04:2014,lysocleanse,http://click2hit.com/lysocleanse,785,788,-3
11:04:2014,massivevitality,http://click2hit.com/massivevitality,30,31,-1
11:04:2014,masspmnight,http://click2hit.com/masspmnight,38,38,0
11:04:2014,maxburncambogia,http://click2hit.com/maxburncambogia,6930,6936,-6
11:04:2014,maxcleanse,http://click2hit.com/maxcleanse,273,273,0
11:04:2014,maxdetox,http://click2hit.com/maxdetox,377,377,0
11:04:2014,maxgarciniaburn,http://click2hit.com/maxgarciniaburn,270,272,-2
11:04:2014,maxleanx,http://click2hit.com/maxleanx,281,281,0
11:04:2014,maxlight,http://click2hit.com/maxlight,11,12,-1
11:04:2014,maxmuscleblast,http://click2hit.com/maxmuscleblast,4,5,-1
11:04:2014,maxmusclelean,http://click2hit.com/maxmusclelean,48,48,0
11:04:2014,maxtrimraspberryketone,http://click2hit.com/maxtrimraspberryketone,111,111,0
11:04:2014,maxxmale,http://click2hit.com/maxxmale,183,186,-3
11:04:2014,maxxtest300,http://click2hit.com/maxxtest300,36,40,-4
11:04:2014,miraclegarciniacambogia1300,http://click2hit.com/miraclegarciniacambogia1300,54,54,0
11:04:2014,miraclegarciniacambogiarx,http://click2hit.com/miraclegarciniacambogiarx,80,82,-2
11:04:2014,miraclephytoceramides,http://click2hit.com/miraclephytoceramides,2260,2277,-17
11:04:2014,miracleraspberryketone,http://click2hit.com/miracleraspberryketone,29,32,-3
11:04:2014,mitoslim,http://click2hit.com/mitoslim,749,750,-1
11:04:2014,mizulean,http://click2hit.com/mizulean,245,245,0
11:04:2014,musclecorex,http://click2hit.com/musclecorex,514,516,-2
11:04:2014,muscleforcex,http://click2hit.com/muscleforcex,89,89,0
11:04:2014,musclekingpro,http://click2hit.com/musclekingpro,303,303,0
11:04:2014,musclemax,http://click2hit.com/musclemax,230,231,-1
11:04:2014,muscleripx,http://click2hit.com/muscleripx,217,219,-2
11:04:2014,musclexedge,http://click2hit.com/musclexedge,529,529,0
11:04:2014,musclexpro,http://click2hit.com/musclexpro,99,100,-1
11:04:2014,musclezx90,http://click2hit.com/musclezx90,2908,2913,-5
11:04:2014,naturalburn,http://click2hit.com/naturalburn,258,259,-1
11:04:2014,naturalcleanse,http://click2hit.com/naturalcleanse,812,815,-3
11:04:2014,naturalcoloncleanseelite,http://click2hit.com/naturalcoloncleanseelite,330,331,-1
11:04:2014,naturaldiet,http://click2hit.com/naturaldiet,148,148,0
11:04:2014,naturalgarciniacambogiaburn,http://click2hit.com/naturalgarciniacambogiaburn,241,243,-2
11:04:2014,naturalgreencleanse,http://click2hit.com/naturalgreencleanse,555,557,-2
11:04:2014,naturalgreencoffeeburn,http://click2hit.com/naturalgreencoffeeburn,424,424,0
11:04:2014,naturalpluscleanse,http://click2hit.com/naturalpluscleanse,138,138,0
11:04:2014,naturalpurecleanse,http://click2hit.com/naturalpurecleanse,395,395,0
11:04:2014,neucleanseultimate,http://click2hit.com/neucleanseultimate,469,486,-17
11:04:2014,neugarciniacambogia,http://click2hit.com/neugarciniacambogia,20,23,-3
11:04:2014,neuropathysupportformula,http://click2hit.com/neuropathysupportformula,265,271,-6
11:04:2014,newagecleanse,http://click2hit.com/newagecleanse,337,338,-1
11:04:2014,newlifecleanse,http://click2hit.com/newlifecleanse,160,161,-1
11:04:2014,nidora,http://click2hit.com/nidora,645,702,-57
11:04:2014,nitricmaxmuscle,http://click2hit.com/nitricmaxmuscle,325,327,-2
11:04:2014,nitricmaxmuscle1,http://click2hit.com/nitricmaxmuscle1,63,63,0
11:04:2014,nitricpower,http://click2hit.com/nitricpower,15,16,-1
11:04:2014,nitroxin,http://click2hit.com/nitroxin,49,54,-5
11:04:2014,nitroxl,http://click2hit.com/nitroxl,282,282,0
11:04:2014,nitroxpro,http://click2hit.com/nitroxpro,6955,7024,-69
11:04:2014,no2explodeextreme,http://click2hit.com/no2explodeextreme,1517,1527,-10
11:04:2014,no2factor,http://click2hit.com/no2factor,332,332,0
11:04:2014,no2maximus,http://click2hit.com/no2maximus,2503,2526,-23
11:04:2014,no2surge,http://click2hit.com/no2surge,347,360,-13
11:04:2014,nuetrim,http://click2hit.com/nuetrim,429,429,0
11:04:2014,nutraburn10,http://click2hit.com/nutraburn10,97,98,-1
11:04:2014,nutranaturalgarciniacambogia,http://click2hit.com/nutranaturalgarciniacambogia,118,118,0
11:04:2014,nutridiet,http://click2hit.com/nutridiet,1110,1115,-5
11:04:2014,nuvagenic,http://click2hit.com/nuvagenic,197,197,0
11:04:2014,nuvie,http://click2hit.com/nuvie,178,179,-1
11:04:2014,nuvocleanse,http://click2hit.com/nuvocleanse,591,591,0
11:04:2014,nuvoslim,http://click2hit.com/nuvoslim,486,498,-12
11:04:2014,onemoment,http://click2hit.com/onemoment,192,200,-8
11:04:2014,optimalstack,http://click2hit.com/optimalstack,497,502,-5
11:04:2014,organiccleanse,http://click2hit.com/organiccleanse,3,3,0
11:04:2014,organiccleansedetox,http://click2hit.com/organiccleansedetox,71,84,-13
11:04:2014,organicgarciniacambogia,http://click2hit.com/organicgarciniacambogia,195,195,0
11:04:2014,originalgarciniacambogia,http://click2hit.com/originalgarciniacambogia,62,64,-2
11:04:2014,originalyaconextract,http://click2hit.com/originalyaconextract,155,155,0
11:04:2014,originalyaconsyrup,http://click2hit.com/originalyaconsyrup,57,57,0
11:04:2014,orvigomax,http://click2hit.com/orvigomax,86,89,-3
11:04:2014,ourgreencleanse,http://click2hit.com/ourgreencleanse,149,149,0
11:04:2014,oxygenius,http://click2hit.com/oxygenius,1414,1419,-5
11:04:2014,pelevoni,http://click2hit.com/pelevoni,322,323,-1
11:04:2014,platinumgarciniacambogia,http://click2hit.com/platinumgarciniacambogia,372,372,0
11:04:2014,poshcream,http://click2hit.com/poshcream,51,52,-1
11:04:2014,powermax,http://click2hit.com/powermax,12,13,-1
11:04:2014,powerprecision,http://click2hit.com/powerprecision,121,121,0
11:04:2014,poweruphealthgarcinia,http://click2hit.com/poweruphealthgarcinia,193,196,-3
11:04:2014,premiermangocleanse,http://click2hit.com/premiermangocleanse,205,205,0
11:04:2014,premiumgarciniacambogiaslim,http://click2hit.com/premiumgarciniacambogiaslim,163,183,-20
11:04:2014,premiumgreencoffeebean,http://click2hit.com/premiumgreencoffeebean,208,209,-1
11:04:2014,procollagen,http://click2hit.com/procollagen,267,267,0
11:04:2014,procoloncleanse,http://click2hit.com/procoloncleanse,168,168,0
11:04:2014,prodermagenix,http://click2hit.com/prodermagenix,189,191,-2
11:04:2014,prodermagenixplus,http://click2hit.com/prodermagenixplus,261,262,-1
11:04:2014,progain350,http://click2hit.com/progain350,3,3,0
11:04:2014,prolong,http://click2hit.com/prolong,761,790,-29
11:04:2014,prolongz,http://click2hit.com/prolongz,499,509,-10
11:04:2014,promusclecomplex,http://click2hit.com/promusclecomplex,542,542,0
11:04:2014,pronutragarcinia,http://click2hit.com/pronutragarcinia,60,60,0
11:04:2014,protrim,http://click2hit.com/protrim,1048,1049,-1
11:04:2014,purafit,http://click2hit.com/purafit,370,370,0
11:04:2014,puragreencoffee,http://click2hit.com/puragreencoffee,290,291,-1
11:04:2014,pureberrymax,http://click2hit.com/pureberrymax,270,271,-1
11:04:2014,purebiodiet,http://click2hit.com/purebiodiet,662,663,-1
11:04:2014,purecambogiaultra,http://click2hit.com/purecambogiaultra,227,234,-7
11:04:2014,purecambogiaultra-1,http://click2hit.com/purecambogiaultra-1,614,618,-4
11:04:2014,purecambogiaultra2,http://click2hit.com/purecambogiaultra2,182,191,-9
11:04:2014,purecleanse,http://click2hit.com/purecleanse,501,504,-3
11:04:2014,purecleansemax,http://click2hit.com/purecleansemax,4,5,-1
11:04:2014,purecolocleanse,http://click2hit.com/purecolocleanse,271,271,0
11:04:2014,purecoloncleanser,http://click2hit.com/purecoloncleanser,1555,1557,-2
11:04:2014,puregarciniacambogia,http://click2hit.com/puregarciniacambogia,195,195,0
11:04:2014,puregarciniacambogia-1,http://click2hit.com/puregarciniacambogia-1,7984,8069,-85
11:04:2014,puregarciniacambogiaburn,http://click2hit.com/puregarciniacambogiaburn,2336,2341,-5
11:04:2014,puregarciniacambogiaplus,http://click2hit.com/puregarciniacambogiaplus,379,379,0
11:04:2014,puregarciniacambogiapremium,http://click2hit.com/puregarciniacambogiapremium,1256,1267,-11
11:04:2014,puregarciniacambogiaslim,http://click2hit.com/puregarciniacambogiaslim,893,893,0
11:04:2014,puregarciniacambogiaslimsystem,http://click2hit.com/puregarciniacambogiaslimsystem,253,254,-1
11:04:2014,puregarciniacanada,http://click2hit.com/puregarciniacanada,57,57,0
11:04:2014,puregarciniaelite,http://click2hit.com/puregarciniaelite,32,32,0
11:04:2014,puregarciniaslim,http://click2hit.com/puregarciniaslim,345,174,171
11:04:2014,puregarciniaultra,http://click2hit.com/puregarciniaultra,536,541,-5
11:04:2014,puregarciniaultra-1,http://click2hit.com/puregarciniaultra-1,134,135,-1
11:04:2014,puregreencoffee,http://click2hit.com/puregreencoffee,420,420,0
11:04:2014,puregreencoffeebeanplus,http://click2hit.com/puregreencoffeebeanplus,38,44,-6
11:04:2014,purelifecleanse1,http://click2hit.com/purelifecleanse1,649,742,-93
11:04:2014,purenitrate,http://click2hit.com/purenitrate,97,105,-8
11:04:2014,purenitromax,http://click2hit.com/purenitromax,504,506,-2
11:04:2014,purensa,http://click2hit.com/purensa,1674,1679,-5
11:04:2014,pureraspberryketonepremium,http://click2hit.com/pureraspberryketonepremium,239,241,-2
11:04:2014,puressance,http://click2hit.com/puressance,125,128,-3
11:04:2014,purestgarciniacambogia,http://click2hit.com/purestgarciniacambogia,22,23,-1
11:04:2014,pureyaconsyrupextract,http://click2hit.com/pureyaconsyrupextract,260,273,-13
11:04:2014,pureyaconsyrupplus,http://click2hit.com/pureyaconsyrupplus,150,150,0
11:04:2014,pureyaconxt,http://click2hit.com/pureyaconxt,77,77,0
11:04:2014,px800greencoffee,http://click2hit.com/px800greencoffee,60,60,0
11:04:2014,quickgreencoffee,http://click2hit.com/quickgreencoffee,396,396,0
11:04:2014,raspberryketonefresh,http://click2hit.com/raspberryketonefresh,1081,1084,-3
11:04:2014,raspberryketoneproslim,http://click2hit.com/raspberryketoneproslim,319,324,-5
11:04:2014,raspberryketones,http://click2hit.com/raspberryketones,344,349,-5
11:04:2014,raspberryslimplus,http://click2hit.com/raspberryslimplus,178,178,0
11:04:2014,raspberrytones,http://click2hit.com/raspberrytones,364,365,-1
11:04:2014,raspberrytrim,http://click2hit.com/raspberrytrim,155,156,-1
11:04:2014,raspberryultraketone,http://click2hit.com/raspberryultraketone,203,203,0
11:04:2014,rawburn,http://click2hit.com/rawburn,145,145,0
11:04:2014,regularx,http://click2hit.com/regularx,122,130,-8
11:04:2014,rejouvance,http://click2hit.com/rejouvance,486,487,-1
11:04:2014,rejuvaglow,http://click2hit.com/rejuvaglow,66,66,0
11:04:2014,rejuvalash,http://click2hit.com/rejuvalash,257,261,-4
11:04:2014,rejuvalskin,http://click2hit.com/rejuvalskin,51,57,-6
11:04:2014,rejuvenex,http://click2hit.com/rejuvenex,352,354,-2
11:04:2014,reliftadvanced,http://click2hit.com/reliftadvanced,270,270,0
11:04:2014,renique,http://click2hit.com/renique,693,702,-9
11:04:2014,restore,http://click2hit.com/restore,86,86,0
11:04:2014,revitol,http://click2hit.com/revitol,65,65,0
11:04:2014,revivagenix,http://click2hit.com/revivagenix,228,229,-1
11:04:2014,revivasol,http://click2hit.com/revivasol,2243,2243,0
11:04:2014,revolyn,http://click2hit.com/revolyn,214,215,-1
11:04:2014,revoreplex,http://click2hit.com/revoreplex,4,208,-204
11:04:2014,rippedmusclex,http://click2hit.com/rippedmusclex,12,12,0
11:04:2014,rvtl,http://click2hit.com/rvtl,1905,1913,-8
11:04:2014,saphireecig,http://click2hit.com/saphireecig,593,593,0
11:04:2014,secretbodybulk,http://click2hit.com/secretbodybulk,308,310,-2
11:04:2014,secretgarciniacambogia,http://click2hit.com/secretgarciniacambogia,249,249,0
11:04:2014,secretlift,http://click2hit.com/secretlift,10,11,-1
11:04:2014,sensa,http://click2hit.com/sensa,132,133,-1
11:04:2014,simplycleanse,http://click2hit.com/simplycleanse,236,237,-1
11:04:2014,simplygarciniacambogia,http://click2hit.com/simplygarciniacambogia,438,442,-4
11:04:2014,simplygreencoffee,http://click2hit.com/simplygreencoffee,331,332,-1
11:04:2014,skinliftadvanced,http://click2hit.com/skinliftadvanced,222,222,0
11:04:2014,skinnyfiber,http://click2hit.com/skinnyfiber,397,398,-1
11:04:2014,slendera-1,http://click2hit.com/slendera-1,39,40,-1
11:04:2014,slendera-sab,http://click2hit.com/slendera-sab,70,73,-3
11:04:2014,slimberrymax,http://click2hit.com/slimberrymax,258,258,0
11:04:2014,slimbodycleanse,http://click2hit.com/slimbodycleanse,3114,3119,-5
11:04:2014,slimbodyketones,http://click2hit.com/slimbodyketones,146,152,-6
11:04:2014,slimcleanseplus,http://click2hit.com/slimcleanseplus,111,113,-2
11:04:2014,slimlean,http://click2hit.com/slimlean,1038,1038,0
11:04:2014,slimnogym,http://click2hit.com/slimnogym,223,223,0
11:04:2014,slimtrimpm,http://click2hit.com/slimtrimpm,89,104,-15
11:04:2014,smileprodirect,http://click2hit.com/smileprodirect,2994,3016,-22
11:04:2014,solpria,http://click2hit.com/solpria,1087,1087,0
11:04:2014,sparkwhitening,http://click2hit.com/sparkwhitening,1603,1604,-1
11:04:2014,strawberrygarciniacambogia,http://click2hit.com/strawberrygarciniacambogia,453,456,-3
11:04:2014,superbetaprostate,http://click2hit.com/superbetaprostate,152,152,0
11:04:2014,supercoloncleanse1800,http://click2hit.com/supercoloncleanse1800,289,290,-1
11:04:2014,supergarciniacambogia,http://click2hit.com/supergarciniacambogia,1005,1013,-8
11:04:2014,superiorvelvet,http://click2hit.com/superiorvelvet,495,504,-9
11:04:2014,superketoneplus,http://click2hit.com/superketoneplus,4109,4133,-24
11:04:2014,superlean,http://click2hit.com/superlean,201,201,0
11:04:2014,superleancoloncleanse,http://click2hit.com/superleancoloncleanse,1345,1348,-3
11:04:2014,supertestoboost,http://click2hit.com/supertestoboost,134,134,0
11:04:2014,superyaconsyrup1000,http://click2hit.com/superyaconsyrup1000,24,24,0
11:04:2014,supracleanse350,http://click2hit.com/supracleanse350,790,849,-59
11:04:2014,supremeantler,http://click2hit.com/supremeantler,145,147,-2
11:04:2014,svelme,http://click2hit.com/svelme,46,46,0
11:04:2014,swolecreatinemuscle,http://click2hit.com/swolecreatinemuscle,186,186,0
11:04:2014,syneocell,http://click2hit.com/syneocell,188,189,-1
11:04:2014,tadvance,http://click2hit.com/tadvance,472,473,-1
11:04:2014,testabolancyp,http://click2hit.com/testabolancyp,343,343,0
11:04:2014,testocoreadvanced,http://click2hit.com/testocoreadvanced,316,326,-10
11:04:2014,testoforceedge,http://click2hit.com/testoforceedge,480,481,-1
11:04:2014,testoforcex,http://click2hit.com/testoforcex,294,295,-1
11:04:2014,testolimit,http://click2hit.com/testolimit,42,42,0
11:04:2014,testomax,http://click2hit.com/testomax,277,278,-1
11:04:2014,testoril,http://click2hit.com/testoril,522,523,-1
11:04:2014,testorushrx,http://click2hit.com/testorushrx,446,456,-10
11:04:2014,testoupmax,http://click2hit.com/testoupmax,134,142,-8
11:04:2014,testrx360,http://click2hit.com/testrx360,334,334,0
11:04:2014,testtoforcextreme,http://click2hit.com/testtoforcextreme,387,387,0
11:04:2014,testx180,http://click2hit.com/testx180,1417,1422,-5
11:04:2014,thermoblackx,http://click2hit.com/thermoblackx,142,142,0
11:04:2014,thermoextreme1,http://click2hit.com/thermoextreme1,570,570,0
11:04:2014,thermofactorx,http://click2hit.com/thermofactorx,820,821,-1
11:04:2014,thermosculptpro,http://click2hit.com/thermosculptpro,323,323,0
11:04:2014,titaniumprox,http://click2hit.com/titaniumprox,797,797,0
11:04:2014,tlevelboost,http://click2hit.com/tlevelboost,65,65,0
11:04:2014,tonaderm,http://click2hit.com/tonaderm,203,205,-2
11:04:2014,totalcleansecomplete,http://click2hit.com/totalcleansecomplete,386,390,-4
11:04:2014,trigx2,http://click2hit.com/trigx2,330,331,-1
11:04:2014,trimextrin,http://click2hit.com/trimextrin,0,0,0
11:04:2014,truburnplus,http://click2hit.com/truburnplus,45,48,-3
11:04:2014,truecleansecomplete,http://click2hit.com/truecleansecomplete,218,223,-5
11:04:2014,turbofrce,http://click2hit.com/turbofrce,423,426,-3
11:04:2014,ultracelebdiet,http://click2hit.com/ultracelebdiet,361,361,0
11:04:2014,ultracleansepure,http://click2hit.com/ultracleansepure,3,3,0
11:04:2014,ultracoloncleanse,http://click2hit.com/ultracoloncleanse,44,45,-1
11:04:2014,ultrafinesse,http://click2hit.com/ultrafinesse,85,86,-1
11:04:2014,ultragarciniacambogia,http://click2hit.com/ultragarciniacambogia,52,53,-1
11:04:2014,ultramaxtestosterone,http://click2hit.com/ultramaxtestosterone,230,231,-1
11:04:2014,ultraslim,http://click2hit.com/ultraslim,189,189,0
11:04:2014,umoris,http://click2hit.com/umoris,412,415,-3
11:04:2014,vantage,http://click2hit.com/vantage,5,5,0
11:04:2014,vapexecig,http://click2hit.com/vapexecig,342,342,0
11:04:2014,vimaxdetox,http://click2hit.com/vimaxdetox,886,890,-4
11:04:2014,virilityex,http://click2hit.com/virilityex,203,203,0
11:04:2014,vitaberryburn,http://click2hit.com/vitaberryburn,371,371,0
11:04:2014,vitaberrytrim,http://click2hit.com/vitaberrytrim,1807,1818,-11
11:04:2014,vitacleanse,http://click2hit.com/vitacleanse,4622,4666,-44
11:04:2014,vitaketone,http://click2hit.com/vitaketone,953,963,-10
11:04:2014,vitalcleanse,http://click2hit.com/vitalcleanse,181,181,0
11:04:2014,vitalcleansecomplete,http://click2hit.com/vitalcleansecomplete,764,765,-1
11:04:2014,vitalifedetox,http://click2hit.com/vitalifedetox,743,744,-1
11:04:2014,vitalikortest,http://click2hit.com/vitalikortest,600,603,-3
11:04:2014,vitalipo,http://click2hit.com/vitalipo,122,123,-1
11:04:2014,vitalitygreencoffee,http://click2hit.com/vitalitygreencoffee,197,197,0
11:04:2014,vitamaxgarciniacambogia,http://click2hit.com/vitamaxgarciniacambogia,1834,1850,-16
11:04:2014,vyalis,http://click2hit.com/vyalis,238,238,0
11:04:2014,wrinklerewind,http://click2hit.com/wrinklerewind,5765,5785,-20
11:04:2014,xmrecovery,http://click2hit.com/xmrecovery,148,148,0
11:04:2014,xtremegarciniacambogia,http://click2hit.com/xtremegarciniacambogia,484,485,-1
11:04:2014,xtremenitro,http://click2hit.com/xtremenitro,56,61,-5
11:04:2014,xtremetestosteronebooster,http://click2hit.com/xtremetestosteronebooster,366,367,-1
11:04:2014,yaconmolasses,http://click2hit.com/yaconmolasses,81,82,-1
11:04:2014,yaconrootmax,http://click2hit.com/yaconrootmax,1349,1436,-87
11:04:2014,yaconsyrupdirect,http://click2hit.com/yaconsyrupdirect,218,219,-1
11:04:2014,yolosleep,http://click2hit.com/yolosleep,213,213,0
11:04:2014,youthkitantiaging,http://click2hit.com/youthkitantiaging,199,199,0
11:04:2014,zenacose,http://click2hit.com/zenacose,164,164,0
11:04:2014,zenscleanse,http://click2hit.com/zenscleanse,2641,2660,-19
11:04:2014,zinncollection,http://click2hit.com/zinncollection,180,180,0
11:04:2014,zolyria,http://click2hit.com/zolyria,504,509,-5
11:04:2014,zyloslim,http://click2hit.com/zyloslim,3771,3774,-3
11:04:2014,zymbiotix,http://click2hit.com/zymbiotix,1289,1295,-6
