dt_today,sitetitle,sitelink,pre_click,new_clicks,difrnce
12:04:2014,5stargarciniacambogia,http://click2hit.com/5stargarciniacambogia,87,89,-2
12:04:2014,Adrenalast,http://click2hit.com/Adrenalast,549,551,-2
12:04:2014,Anataflex,http://click2hit.com/Anataflex,1306,1306,0
12:04:2014,Diabetix,http://click2hit.com/Diabetix,726,727,-1
12:04:2014,Equinox,http://click2hit.com/Equinox,8785,8823,-38
12:04:2014,LuxeCoat,http://click2hit.com/LuxeCoat,416,416,0
12:04:2014,NOX360,http://click2hit.com/NOX360,54,56,-2
12:04:2014,Prescopodene,http://click2hit.com/Prescopodene,1357,1358,-1
12:04:2014,Puregarciniaslim,http://click2hit.com/Puregarciniaslim,174,345,-171
12:04:2014,RevoReplex,http://click2hit.com/RevoReplex,208,4,204
12:04:2014,absoluteraspberryketone,http://click2hit.com/absoluteraspberryketone,10,10,0
12:04:2014,acaiberrypuremax,http://click2hit.com/acaiberrypuremax,180,180,0
12:04:2014,actionprowhite,http://click2hit.com/actionprowhite,178,186,-8
12:04:2014,activedetoxcleanse,http://click2hit.com/activedetoxcleanse,36,37,-1
12:04:2014,activeraspberryketone,http://click2hit.com/activeraspberryketone,145,168,-23
12:04:2014,advancedgarciniacambogia,http://click2hit.com/advancedgarciniacambogia,779,779,0
12:04:2014,advancedpuregarcinia,http://click2hit.com/advancedpuregarcinia,555,555,0
12:04:2014,advancedtest,http://click2hit.com/advancedtest,573,573,0
12:04:2014,advancedtrimgreencoffee,http://click2hit.com/advancedtrimgreencoffee,1690,1692,-2
12:04:2014,africanmangopremier,http://click2hit.com/africanmangopremier,746,746,0
12:04:2014,agelesshealthsolution,http://click2hit.com/agelesshealthsolution,128,130,-2
12:04:2014,alleureantiagingcream,http://click2hit.com/alleureantiagingcream,302,309,-7
12:04:2014,alleureeyeserum,http://click2hit.com/alleureeyeserum,346,368,-22
12:04:2014,aloeferoxcleanse,http://click2hit.com/aloeferoxcleanse,25,34,-9
12:04:2014,aloeveracleanse,http://click2hit.com/aloeveracleanse,658,659,-1
12:04:2014,alore,http://click2hit.com/alore,3977,4002,-25
12:04:2014,alphacuthd,http://click2hit.com/alphacuthd,60,61,-1
12:04:2014,alphagenix,http://click2hit.com/alphagenix,87,99,-12
12:04:2014,alphamale,http://click2hit.com/alphamale,201,201,0
12:04:2014,alphamax1,http://click2hit.com/alphamax1,255,257,-2
12:04:2014,amacari,http://click2hit.com/amacari,154,155,-1
12:04:2014,amazingcleanse,http://click2hit.com/amazingcleanse,2,2,0
12:04:2014,ambitrimrx,http://click2hit.com/ambitrimrx,776,776,0
12:04:2014,amino,http://click2hit.com/amino,1272,1275,-3
12:04:2014,andromale,http://click2hit.com/andromale,539,540,-1
12:04:2014,anoradrol,http://click2hit.com/anoradrol,86,86,0
12:04:2014,aussiegarciniacambogia,http://click2hit.com/aussiegarciniacambogia,166,166,0
12:04:2014,authenticgarciniacambogia,http://click2hit.com/authenticgarciniacambogia,83,83,0
12:04:2014,beaute,http://click2hit.com/beaute,649,649,0
12:04:2014,bellaathome,http://click2hit.com/bellaathome,1780,1802,-22
12:04:2014,bellapure,http://click2hit.com/bellapure,1798,1812,-14
12:04:2014,bellecomplex,http://click2hit.com/bellecomplex,659,660,-1
12:04:2014,berryherbalcleanse,http://click2hit.com/berryherbalcleanse,572,573,-1
12:04:2014,berrythingarciniacambogia,http://click2hit.com/berrythingarciniacambogia,540,540,0
12:04:2014,betaalalinemax,http://click2hit.com/betaalalinemax,570,570,0
12:04:2014,betaboost,http://click2hit.com/betaboost,108,108,0
12:04:2014,betaforce,http://click2hit.com/betaforce,656,656,0
12:04:2014,beyondraspberryketone,http://click2hit.com/beyondraspberryketone,2101,2101,0
12:04:2014,biocareslimplus,http://click2hit.com/biocareslimplus,314,315,-1
12:04:2014,biocarexl,http://click2hit.com/biocarexl,328,329,-1
12:04:2014,biogeniste,http://click2hit.com/biogeniste,453,457,-4
12:04:2014,blackbullmaleenhancement,http://click2hit.com/blackbullmaleenhancement,1459,1461,-2
12:04:2014,blackdiamond,http://click2hit.com/blackdiamond,541,559,-18
12:04:2014,blacklineelite,http://click2hit.com/blacklineelite,1559,1563,-4
12:04:2014,blastxl,http://click2hit.com/blastxl,144,145,-1
12:04:2014,blizzadwhite,http://click2hit.com/blizzadwhite,45,66,-21
12:04:2014,bluemagicplus,http://click2hit.com/bluemagicplus,879,883,-4
12:04:2014,bodyfuelxs,http://click2hit.com/bodyfuelxs,90,90,0
12:04:2014,brandnew,http://click2hit.com/brandnew,351,351,0
12:04:2014,brandnewbooty,http://click2hit.com/brandnewbooty,777,778,-1
12:04:2014,cafevertextraminceur,http://click2hit.com/cafevertextraminceur,2641,2716,-75
12:04:2014,carbuloss,http://click2hit.com/carbuloss,388,391,-3
12:04:2014,celebritybodynow,http://click2hit.com/celebritybodynow,423,424,-1
12:04:2014,celebrityweightlosskit,http://click2hit.com/celebrityweightlosskit,361,362,-1
12:04:2014,cellanafricanmango,http://click2hit.com/cellanafricanmango,2369,2406,-37
12:04:2014,cellogicaskin,http://click2hit.com/cellogicaskin,197,200,-3
12:04:2014,cenaless,http://click2hit.com/cenaless,75,75,0
12:04:2014,cenaslim,http://click2hit.com/cenaslim,396,396,0
12:04:2014,cleandetox,http://click2hit.com/cleandetox,274,275,-1
12:04:2014,cleansecatalystplus,http://click2hit.com/cleansecatalystplus,3363,3374,-11
12:04:2014,cleanseultimo,http://click2hit.com/cleanseultimo,1423,1424,-1
12:04:2014,cocogeniceyeserum,http://click2hit.com/cocogeniceyeserum,17,18,-1
12:04:2014,coffeecleansemax,http://click2hit.com/coffeecleansemax,397,398,-1
12:04:2014,coffeepurecleanse,http://click2hit.com/coffeepurecleanse,69,77,-8
12:04:2014,coleanse,http://click2hit.com/coleanse,2115,2118,-3
12:04:2014,collagen,http://click2hit.com/collagen,31,33,-2
12:04:2014,collagenfaceserum,http://click2hit.com/collagenfaceserum,52,54,-2
12:04:2014,colodetox,http://click2hit.com/colodetox,532,536,-4
12:04:2014,colodetoxplus,http://click2hit.com/colodetoxplus,93,94,-1
12:04:2014,coloncleanse1300,http://click2hit.com/coloncleanse1300,287,289,-2
12:04:2014,coloncleansecomplete,http://click2hit.com/coloncleansecomplete,1305,1305,0
12:04:2014,coloncleansetotal,http://click2hit.com/coloncleansetotal,775,778,-3
12:04:2014,colondetoxpro,http://click2hit.com/colondetoxpro,53,58,-5
12:04:2014,colonpurecleanse,http://click2hit.com/colonpurecleanse,429,432,-3
12:04:2014,colothin,http://click2hit.com/colothin,195,197,-2
12:04:2014,columbiangreencoffeebean,http://click2hit.com/columbiangreencoffeebean,790,796,-6
12:04:2014,combogiaplus,http://click2hit.com/combogiaplus,331,331,0
12:04:2014,completecoffeecleanse,http://click2hit.com/completecoffeecleanse,400,400,0
12:04:2014,complexiderm,http://click2hit.com/complexiderm,187,187,0
12:04:2014,cosimarevival,http://click2hit.com/cosimarevival,184,185,-1
12:04:2014,cosmitone,http://click2hit.com/cosmitone,1336,1337,-1
12:04:2014,csorex,http://click2hit.com/csorex,108,108,0
12:04:2014,curcovia,http://click2hit.com/curcovia,427,428,-1
12:04:2014,cutiecurves,http://click2hit.com/cutiecurves,246,246,0
12:04:2014,cytotrim,http://click2hit.com/cytotrim,5,6,-1
12:04:2014,dailyeyerestoration,http://click2hit.com/dailyeyerestoration,158,158,0
12:04:2014,dellure,http://click2hit.com/dellure,119,121,-2
12:04:2014,dellurecollagen,http://click2hit.com/dellurecollagen,571,572,-1
12:04:2014,dermafirm,http://click2hit.com/dermafirm,765,768,-3
12:04:2014,dermajuvenate,http://click2hit.com/dermajuvenate,2373,2385,-12
12:04:2014,dermalift,http://click2hit.com/dermalift,235,237,-2
12:04:2014,dermallo,http://click2hit.com/dermallo,270,270,0
12:04:2014,dermalmeds,http://click2hit.com/dermalmeds,448,448,0
12:04:2014,dermangelie,http://click2hit.com/dermangelie,156,156,0
12:04:2014,derminelift,http://click2hit.com/derminelift,405,406,-1
12:04:2014,dermology,http://click2hit.com/dermology,46,46,0
12:04:2014,detoxmax,http://click2hit.com/detoxmax,61,61,0
12:04:2014,dietultimo,http://click2hit.com/dietultimo,2549,2562,-13
12:04:2014,digestItcoloncleanse,http://click2hit.com/digestItcoloncleanse,67,68,-1
12:04:2014,duplicellp199,http://click2hit.com/duplicellp199,56,58,-2
12:04:2014,duplicellp199facetherapy,http://click2hit.com/duplicellp199facetherapy,56,59,-3
12:04:2014,ecoflex,http://click2hit.com/ecoflex,130,133,-3
12:04:2014,electravx,http://click2hit.com/electravx,182,182,0
12:04:2014,elevategf,http://click2hit.com/elevategf,269,271,-2
12:04:2014,elite360,http://click2hit.com/elite360,71,71,0
12:04:2014,elliskin,http://click2hit.com/elliskin,512,513,-1
12:04:2014,endorev,http://click2hit.com/endorev,464,466,-2
12:04:2014,ephedrix,http://click2hit.com/ephedrix,229,230,-1
12:04:2014,equivita,http://click2hit.com/equivita,7956,7980,-24
12:04:2014,essentialdetox,http://click2hit.com/essentialdetox,432,433,-1
12:04:2014,extagen,http://click2hit.com/extagen,340,341,-1
12:04:2014,extremefx,http://click2hit.com/extremefx,351,352,-1
12:04:2014,eyeluminous,http://click2hit.com/eyeluminous,718,731,-13
12:04:2014,fembalance,http://click2hit.com/fembalance,365,366,-1
12:04:2014,firmativ,http://click2hit.com/firmativ,914,931,-17
12:04:2014,flawlessbeauty,http://click2hit.com/flawlessbeauty,110,113,-3
12:04:2014,flexwell,http://click2hit.com/flexwell,103,103,0
12:04:2014,forceeffect,http://click2hit.com/forceeffect,406,448,-42
12:04:2014,formularezvmagic,http://click2hit.com/formularezvmagic,231,232,-1
12:04:2014,fortdietmax,http://click2hit.com/fortdietmax,82,82,0
12:04:2014,fortmaxdiet,http://click2hit.com/fortmaxdiet,74,74,0
12:04:2014,garciniaberrythin,http://click2hit.com/garciniaberrythin,480,480,0
12:04:2014,garciniacambogia1300,http://click2hit.com/garciniacambogia1300,664,665,-1
12:04:2014,garciniacambogia360,http://click2hit.com/garciniacambogia360,24,25,-1
12:04:2014,garciniacambogia500,http://click2hit.com/garciniacambogia500,3,3,0
12:04:2014,garciniacambogiablast,http://click2hit.com/garciniacambogiablast,776,778,-2
12:04:2014,garciniacambogiaburn,http://click2hit.com/garciniacambogiaburn,100,100,0
12:04:2014,garciniacambogiacomplex,http://click2hit.com/garciniacambogiacomplex,334,337,-3
12:04:2014,garciniacambogiaextract,http://click2hit.com/garciniacambogiaextract,48,49,-1
12:04:2014,garciniacambogiafit1300,http://click2hit.com/garciniacambogiafit1300,151,155,-4
12:04:2014,garciniacambogiaformula,http://click2hit.com/garciniacambogiaformula,42,44,-2
12:04:2014,garciniacambogiahca,http://click2hit.com/garciniacambogiahca,5,6,-1
12:04:2014,garciniacambogiaplus,http://click2hit.com/garciniacambogiaplus,1135,1138,-3
12:04:2014,garciniacambogiapro,http://click2hit.com/garciniacambogiapro,21,21,0
12:04:2014,garciniacambogiaselect,http://click2hit.com/garciniacambogiaselect,492,492,0
12:04:2014,garciniacambogiaslimfast,http://click2hit.com/garciniacambogiaslimfast,1824,1833,-9
12:04:2014,garciniacambogiaslimsystem,http://click2hit.com/garciniacambogiaslimsystem,1136,1142,-6
12:04:2014,garciniacambogiaxt,http://click2hit.com/garciniacambogiaxt,192,205,-13
12:04:2014,garciniacambogiaz,http://click2hit.com/garciniacambogiaz,4,5,-1
12:04:2014,garciniacombogiasupreme,http://click2hit.com/garciniacombogiasupreme,24,24,0
12:04:2014,garciniadietmax,http://click2hit.com/garciniadietmax,343,346,-3
12:04:2014,garciniaextractplus,http://click2hit.com/garciniaextractplus,234,236,-2
12:04:2014,garciniaforte,http://click2hit.com/garciniaforte,4,5,-1
12:04:2014,garciniahca,http://click2hit.com/garciniahca,144,144,0
12:04:2014,garciniahcapremium,http://click2hit.com/garciniahcapremium,111,112,-1
12:04:2014,garciniaplus,http://click2hit.com/garciniaplus,1995,2003,-8
12:04:2014,garciniasuperdiet,http://click2hit.com/garciniasuperdiet,174,174,0
12:04:2014,garciniawonder,http://click2hit.com/garciniawonder,12,19,-7
12:04:2014,garciniawow,http://click2hit.com/garciniawow,102,106,-4
12:04:2014,garciniaxslim,http://click2hit.com/garciniaxslim,587,604,-17
12:04:2014,gc180xt,http://click2hit.com/gc180xt,586,589,-3
12:04:2014,gcbmaxgreencoffee,http://click2hit.com/gcbmaxgreencoffee,346,347,-1
12:04:2014,gcfitsgarcinia,http://click2hit.com/gcfitsgarcinia,6,6,0
12:04:2014,gcxsdiet,http://click2hit.com/gcxsdiet,55,56,-1
12:04:2014,genesis,http://click2hit.com/genesis,43,43,0
12:04:2014,gogiberryburn,http://click2hit.com/gogiberryburn,52,60,-8
12:04:2014,gojiactives,http://click2hit.com/gojiactives,1521,1539,-18
12:04:2014,gojiadvance,http://click2hit.com/gojiadvance,420,421,-1
12:04:2014,gojimax,http://click2hit.com/gojimax,259,263,-4
12:04:2014,gojislim,http://click2hit.com/gojislim,20313,20332,-19
12:04:2014,govapor,http://click2hit.com/govapor,121,134,-13
12:04:2014,greencoffeebeanthin,http://click2hit.com/greencoffeebeanthin,289,289,0
12:04:2014,greencoffeebody,http://click2hit.com/greencoffeebody,419,420,-1
12:04:2014,greencoffeecleanse,http://click2hit.com/greencoffeecleanse,20,20,0
12:04:2014,greencoffeecleanse1,http://click2hit.com/greencoffeecleanse1,29,29,0
12:04:2014,greencoffeecleanses,http://click2hit.com/greencoffeecleanses,918,939,-21
12:04:2014,greencoffeeextraslim,http://click2hit.com/greencoffeeextraslim,275,276,-1
12:04:2014,greencoffeefatburn,http://click2hit.com/greencoffeefatburn,1580,1580,0
12:04:2014,greencoffeenaxx,http://click2hit.com/greencoffeenaxx,197,197,0
12:04:2014,greencoffeeplus,http://click2hit.com/greencoffeeplus,104,105,-1
12:04:2014,greencoffeeprogram,http://click2hit.com/greencoffeeprogram,62,62,0
12:04:2014,greencoffeerevolution,http://click2hit.com/greencoffeerevolution,28,28,0
12:04:2014,greencoffeespeedslim,http://click2hit.com/greencoffeespeedslim,1497,1520,-23
12:04:2014,greencoffeesupreme,http://click2hit.com/greencoffeesupreme,352,352,0
12:04:2014,greencoffeesupremecleanse,http://click2hit.com/greencoffeesupremecleanse,120,120,0
12:04:2014,greendetoxpatch,http://click2hit.com/greendetoxpatch,285,285,0
12:04:2014,greenleancoffeebean,http://click2hit.com/greenleancoffeebean,211,211,0
12:04:2014,greentonepromuscle,http://click2hit.com/greentonepromuscle,215,216,-1
12:04:2014,growxl,http://click2hit.com/growxl,2737,2748,-11
12:04:2014,hairgenesis,http://click2hit.com/hairgenesis,80,80,0
12:04:2014,hardknight,http://click2hit.com/hardknight,1451,1456,-5
12:04:2014,hardknight-1,http://click2hit.com/hardknight-1,84,86,-2
12:04:2014,hawaiislim,http://click2hit.com/hawaiislim,146,147,-1
12:04:2014,healthycleanse,http://click2hit.com/healthycleanse,519,520,-1
12:04:2014,heboost,http://click2hit.com/heboost,236,237,-1
12:04:2014,hghfuel,http://click2hit.com/hghfuel,28,29,-1
12:04:2014,hghpro,http://click2hit.com/hghpro,41,43,-2
12:04:2014,hghxl,http://click2hit.com/hghxl,140,140,0
12:04:2014,hight,http://click2hit.com/hight,325,327,-2
12:04:2014,hspactives,http://click2hit.com/hspactives,2167,2170,-3
12:04:2014,htrush,http://click2hit.com/htrush,325,330,-5
12:04:2014,hydradiance,http://click2hit.com/hydradiance,570,575,-5
12:04:2014,hydrafirm,http://click2hit.com/hydrafirm,260,260,0
12:04:2014,hydravella,http://click2hit.com/hydravella,233,236,-3
12:04:2014,hydroface,http://click2hit.com/hydroface,619,621,-2
12:04:2014,hydroxatone90,http://click2hit.com/hydroxatone90,327,328,-1
12:04:2014,hydroxatonebbcream,http://click2hit.com/hydroxatonebbcream,74,74,0
12:04:2014,idolize,http://click2hit.com/idolize,190,192,-2
12:04:2014,instaleanketones,http://click2hit.com/instaleanketones,706,707,-1
12:04:2014,instantderma,http://click2hit.com/instantderma,185,185,0
12:04:2014,instantlift,http://click2hit.com/instantlift,475,475,0
12:04:2014,juvalife,http://click2hit.com/juvalife,95,97,-2
12:04:2014,juvamend,http://click2hit.com/juvamend,8,10,-2
12:04:2014,juvesiio,http://click2hit.com/juvesiio,57,58,-1
12:04:2014,ketoneadvanced,http://click2hit.com/ketoneadvanced,20,36,-16
12:04:2014,ketonepremium,http://click2hit.com/ketonepremium,530,530,0
12:04:2014,kollagen,http://click2hit.com/kollagen,84,84,0
12:04:2014,l-carnitineplus,http://click2hit.com/l-carnitineplus,149,149,0
12:04:2014,ladermanique,http://click2hit.com/ladermanique,1743,1753,-10
12:04:2014,larginineplus,http://click2hit.com/larginineplus,30,30,0
12:04:2014,leanmusclex,http://click2hit.com/leanmusclex,9,9,0
12:04:2014,leptizin,http://click2hit.com/leptizin,106,106,0
12:04:2014,lifecell,http://click2hit.com/lifecell,141,141,0
12:04:2014,liftandglowpro,http://click2hit.com/liftandglowpro,37,39,-2
12:04:2014,liftderma,http://click2hit.com/liftderma,772,774,-2
12:04:2014,liftserumpro,http://click2hit.com/liftserumpro,56,56,0
12:04:2014,liftvapor,http://click2hit.com/liftvapor,896,896,0
12:04:2014,lipo13,http://click2hit.com/lipo13,1116,1142,-26
12:04:2014,lipog3,http://click2hit.com/lipog3,636,674,-38
12:04:2014,liposlim,http://click2hit.com/liposlim,212,213,-1
12:04:2014,lisocleanse,http://click2hit.com/lisocleanse,308,418,-110
12:04:2014,lorelia,http://click2hit.com/lorelia,2165,2184,-19
12:04:2014,lumeraeyeserum,http://click2hit.com/lumeraeyeserum,2284,2302,-18
12:04:2014,luminant,http://click2hit.com/luminant,397,397,0
12:04:2014,luminantskin,http://click2hit.com/luminantskin,416,417,-1
12:04:2014,luminique,http://click2hit.com/luminique,87,87,0
12:04:2014,luministeyegel,http://click2hit.com/luministeyegel,210,210,0
12:04:2014,lunarsleep,http://click2hit.com/lunarsleep,302,314,-12
12:04:2014,lunathin,http://click2hit.com/lunathin,143,143,0
12:04:2014,lxwpro-t,http://click2hit.com/lxwpro-t,39,41,-2
12:04:2014,lysocleanse,http://click2hit.com/lysocleanse,788,788,0
12:04:2014,massivevitality,http://click2hit.com/massivevitality,31,32,-1
12:04:2014,masspmnight,http://click2hit.com/masspmnight,38,39,-1
12:04:2014,maxburncambogia,http://click2hit.com/maxburncambogia,6936,6946,-10
12:04:2014,maxcleanse,http://click2hit.com/maxcleanse,273,273,0
12:04:2014,maxdetox,http://click2hit.com/maxdetox,377,377,0
12:04:2014,maxgarciniaburn,http://click2hit.com/maxgarciniaburn,272,273,-1
12:04:2014,maxleanx,http://click2hit.com/maxleanx,281,281,0
12:04:2014,maxlight,http://click2hit.com/maxlight,12,14,-2
12:04:2014,maxmuscleblast,http://click2hit.com/maxmuscleblast,5,5,0
12:04:2014,maxmusclelean,http://click2hit.com/maxmusclelean,48,48,0
12:04:2014,maxtrimraspberryketone,http://click2hit.com/maxtrimraspberryketone,111,111,0
12:04:2014,maxxmale,http://click2hit.com/maxxmale,186,186,0
12:04:2014,maxxtest300,http://click2hit.com/maxxtest300,40,42,-2
12:04:2014,miraclegarciniacambogia1300,http://click2hit.com/miraclegarciniacambogia1300,54,54,0
12:04:2014,miraclegarciniacambogiarx,http://click2hit.com/miraclegarciniacambogiarx,82,92,-10
12:04:2014,miraclephytoceramides,http://click2hit.com/miraclephytoceramides,2277,2288,-11
12:04:2014,miracleraspberryketone,http://click2hit.com/miracleraspberryketone,32,34,-2
12:04:2014,mitoslim,http://click2hit.com/mitoslim,750,750,0
12:04:2014,mizulean,http://click2hit.com/mizulean,245,246,-1
12:04:2014,musclecorex,http://click2hit.com/musclecorex,516,518,-2
12:04:2014,muscleforcex,http://click2hit.com/muscleforcex,89,90,-1
12:04:2014,musclekingpro,http://click2hit.com/musclekingpro,303,303,0
12:04:2014,musclemax,http://click2hit.com/musclemax,231,231,0
12:04:2014,muscleripx,http://click2hit.com/muscleripx,219,219,0
12:04:2014,musclexedge,http://click2hit.com/musclexedge,529,529,0
12:04:2014,musclexpro,http://click2hit.com/musclexpro,100,101,-1
12:04:2014,musclezx90,http://click2hit.com/musclezx90,2913,2913,0
12:04:2014,naturalburn,http://click2hit.com/naturalburn,259,259,0
12:04:2014,naturalcleanse,http://click2hit.com/naturalcleanse,815,817,-2
12:04:2014,naturalcoloncleanseelite,http://click2hit.com/naturalcoloncleanseelite,331,332,-1
12:04:2014,naturaldiet,http://click2hit.com/naturaldiet,148,148,0
12:04:2014,naturalgarciniacambogiaburn,http://click2hit.com/naturalgarciniacambogiaburn,243,243,0
12:04:2014,naturalgreencleanse,http://click2hit.com/naturalgreencleanse,557,559,-2
12:04:2014,naturalgreencoffeeburn,http://click2hit.com/naturalgreencoffeeburn,424,424,0
12:04:2014,naturalpluscleanse,http://click2hit.com/naturalpluscleanse,138,139,-1
12:04:2014,naturalpurecleanse,http://click2hit.com/naturalpurecleanse,395,395,0
12:04:2014,neucleanseultimate,http://click2hit.com/neucleanseultimate,486,488,-2
12:04:2014,neugarciniacambogia,http://click2hit.com/neugarciniacambogia,23,25,-2
12:04:2014,neuropathysupportformula,http://click2hit.com/neuropathysupportformula,271,275,-4
12:04:2014,newagecleanse,http://click2hit.com/newagecleanse,338,341,-3
12:04:2014,newlifecleanse,http://click2hit.com/newlifecleanse,161,162,-1
12:04:2014,nidora,http://click2hit.com/nidora,702,745,-43
12:04:2014,nitricmaxmuscle,http://click2hit.com/nitricmaxmuscle,327,330,-3
12:04:2014,nitricmaxmuscle1,http://click2hit.com/nitricmaxmuscle1,63,64,-1
12:04:2014,nitricpower,http://click2hit.com/nitricpower,16,17,-1
12:04:2014,nitroxin,http://click2hit.com/nitroxin,54,61,-7
12:04:2014,nitroxl,http://click2hit.com/nitroxl,282,286,-4
12:04:2014,nitroxpro,http://click2hit.com/nitroxpro,7024,7069,-45
12:04:2014,no2explodeextreme,http://click2hit.com/no2explodeextreme,1527,1534,-7
12:04:2014,no2factor,http://click2hit.com/no2factor,332,333,-1
12:04:2014,no2maximus,http://click2hit.com/no2maximus,2526,2563,-37
12:04:2014,no2surge,http://click2hit.com/no2surge,360,381,-21
12:04:2014,nuetrim,http://click2hit.com/nuetrim,429,431,-2
12:04:2014,nutraburn10,http://click2hit.com/nutraburn10,98,98,0
12:04:2014,nutranaturalgarciniacambogia,http://click2hit.com/nutranaturalgarciniacambogia,118,118,0
12:04:2014,nutridiet,http://click2hit.com/nutridiet,1115,1129,-14
12:04:2014,nuvagenic,http://click2hit.com/nuvagenic,197,197,0
12:04:2014,nuvie,http://click2hit.com/nuvie,179,184,-5
12:04:2014,nuvocleanse,http://click2hit.com/nuvocleanse,591,593,-2
12:04:2014,nuvoslim,http://click2hit.com/nuvoslim,498,505,-7
12:04:2014,onemoment,http://click2hit.com/onemoment,200,208,-8
12:04:2014,optimalstack,http://click2hit.com/optimalstack,502,505,-3
12:04:2014,organiccleanse,http://click2hit.com/organiccleanse,3,4,-1
12:04:2014,organiccleansedetox,http://click2hit.com/organiccleansedetox,84,88,-4
12:04:2014,organicgarciniacambogia,http://click2hit.com/organicgarciniacambogia,195,196,-1
12:04:2014,originalgarciniacambogia,http://click2hit.com/originalgarciniacambogia,64,70,-6
12:04:2014,originalyaconextract,http://click2hit.com/originalyaconextract,155,155,0
12:04:2014,originalyaconsyrup,http://click2hit.com/originalyaconsyrup,57,58,-1
12:04:2014,orvigomax,http://click2hit.com/orvigomax,89,93,-4
12:04:2014,ourgreencleanse,http://click2hit.com/ourgreencleanse,149,150,-1
12:04:2014,oxygenius,http://click2hit.com/oxygenius,1419,1425,-6
12:04:2014,pelevoni,http://click2hit.com/pelevoni,323,323,0
12:04:2014,platinumgarciniacambogia,http://click2hit.com/platinumgarciniacambogia,372,374,-2
12:04:2014,poshcream,http://click2hit.com/poshcream,52,55,-3
12:04:2014,powermax,http://click2hit.com/powermax,13,14,-1
12:04:2014,powerprecision,http://click2hit.com/powerprecision,121,123,-2
12:04:2014,poweruphealthgarcinia,http://click2hit.com/poweruphealthgarcinia,196,198,-2
12:04:2014,premiermangocleanse,http://click2hit.com/premiermangocleanse,205,205,0
12:04:2014,premiumgarciniacambogiaslim,http://click2hit.com/premiumgarciniacambogiaslim,183,206,-23
12:04:2014,premiumgreencoffeebean,http://click2hit.com/premiumgreencoffeebean,209,209,0
12:04:2014,procollagen,http://click2hit.com/procollagen,267,268,-1
12:04:2014,procoloncleanse,http://click2hit.com/procoloncleanse,168,168,0
12:04:2014,prodermagenix,http://click2hit.com/prodermagenix,191,194,-3
12:04:2014,prodermagenixplus,http://click2hit.com/prodermagenixplus,262,262,0
12:04:2014,progain350,http://click2hit.com/progain350,3,3,0
12:04:2014,prolong,http://click2hit.com/prolong,790,810,-20
12:04:2014,prolongz,http://click2hit.com/prolongz,509,517,-8
12:04:2014,promusclecomplex,http://click2hit.com/promusclecomplex,542,543,-1
12:04:2014,pronutragarcinia,http://click2hit.com/pronutragarcinia,60,60,0
12:04:2014,protrim,http://click2hit.com/protrim,1049,1049,0
12:04:2014,purafit,http://click2hit.com/purafit,370,371,-1
12:04:2014,puragreencoffee,http://click2hit.com/puragreencoffee,291,291,0
12:04:2014,pureberrymax,http://click2hit.com/pureberrymax,271,271,0
12:04:2014,purebiodiet,http://click2hit.com/purebiodiet,663,665,-2
12:04:2014,purecambogiaultra,http://click2hit.com/purecambogiaultra,234,244,-10
12:04:2014,purecambogiaultra-1,http://click2hit.com/purecambogiaultra-1,618,631,-13
12:04:2014,purecambogiaultra2,http://click2hit.com/purecambogiaultra2,191,194,-3
12:04:2014,purecleanse,http://click2hit.com/purecleanse,504,505,-1
12:04:2014,purecleansemax,http://click2hit.com/purecleansemax,5,5,0
12:04:2014,purecolocleanse,http://click2hit.com/purecolocleanse,271,273,-2
12:04:2014,purecoloncleanser,http://click2hit.com/purecoloncleanser,1557,1559,-2
12:04:2014,puregarciniacambogia,http://click2hit.com/puregarciniacambogia,195,196,-1
12:04:2014,puregarciniacambogia-1,http://click2hit.com/puregarciniacambogia-1,8069,8139,-70
12:04:2014,puregarciniacambogiaburn,http://click2hit.com/puregarciniacambogiaburn,2341,2348,-7
12:04:2014,puregarciniacambogiaplus,http://click2hit.com/puregarciniacambogiaplus,379,385,-6
12:04:2014,puregarciniacambogiapremium,http://click2hit.com/puregarciniacambogiapremium,1267,1270,-3
12:04:2014,puregarciniacambogiaslim,http://click2hit.com/puregarciniacambogiaslim,893,894,-1
12:04:2014,puregarciniacambogiaslimsystem,http://click2hit.com/puregarciniacambogiaslimsystem,254,255,-1
12:04:2014,puregarciniacanada,http://click2hit.com/puregarciniacanada,57,57,0
12:04:2014,puregarciniaelite,http://click2hit.com/puregarciniaelite,32,32,0
12:04:2014,puregarciniaslim,http://click2hit.com/puregarciniaslim,345,174,171
12:04:2014,puregarciniaultra,http://click2hit.com/puregarciniaultra,541,542,-1
12:04:2014,puregarciniaultra-1,http://click2hit.com/puregarciniaultra-1,135,135,0
12:04:2014,puregreencoffee,http://click2hit.com/puregreencoffee,420,420,0
12:04:2014,puregreencoffeebeanplus,http://click2hit.com/puregreencoffeebeanplus,44,51,-7
12:04:2014,purelifecleanse1,http://click2hit.com/purelifecleanse1,742,804,-62
12:04:2014,purenitrate,http://click2hit.com/purenitrate,105,109,-4
12:04:2014,purenitromax,http://click2hit.com/purenitromax,506,507,-1
12:04:2014,purensa,http://click2hit.com/purensa,1679,1690,-11
12:04:2014,pureraspberryketonepremium,http://click2hit.com/pureraspberryketonepremium,241,241,0
12:04:2014,puressance,http://click2hit.com/puressance,128,129,-1
12:04:2014,purestgarciniacambogia,http://click2hit.com/purestgarciniacambogia,23,23,0
12:04:2014,pureyaconsyrupextract,http://click2hit.com/pureyaconsyrupextract,273,273,0
12:04:2014,pureyaconsyrupplus,http://click2hit.com/pureyaconsyrupplus,150,150,0
12:04:2014,pureyaconxt,http://click2hit.com/pureyaconxt,77,77,0
12:04:2014,px800greencoffee,http://click2hit.com/px800greencoffee,60,61,-1
12:04:2014,quickgreencoffee,http://click2hit.com/quickgreencoffee,396,396,0
12:04:2014,raspberryketonefresh,http://click2hit.com/raspberryketonefresh,1084,1090,-6
12:04:2014,raspberryketoneproslim,http://click2hit.com/raspberryketoneproslim,324,324,0
12:04:2014,raspberryketones,http://click2hit.com/raspberryketones,349,354,-5
12:04:2014,raspberryslimplus,http://click2hit.com/raspberryslimplus,178,178,0
12:04:2014,raspberrytones,http://click2hit.com/raspberrytones,365,366,-1
12:04:2014,raspberrytrim,http://click2hit.com/raspberrytrim,156,156,0
12:04:2014,raspberryultraketone,http://click2hit.com/raspberryultraketone,203,204,-1
12:04:2014,rawburn,http://click2hit.com/rawburn,145,146,-1
12:04:2014,regularx,http://click2hit.com/regularx,130,142,-12
12:04:2014,rejouvance,http://click2hit.com/rejouvance,487,487,0
12:04:2014,rejuvaglow,http://click2hit.com/rejuvaglow,66,66,0
12:04:2014,rejuvalash,http://click2hit.com/rejuvalash,261,261,0
12:04:2014,rejuvalskin,http://click2hit.com/rejuvalskin,57,70,-13
12:04:2014,rejuvenex,http://click2hit.com/rejuvenex,354,354,0
12:04:2014,reliftadvanced,http://click2hit.com/reliftadvanced,270,270,0
12:04:2014,renique,http://click2hit.com/renique,702,722,-20
12:04:2014,restore,http://click2hit.com/restore,86,87,-1
12:04:2014,revitol,http://click2hit.com/revitol,65,66,-1
12:04:2014,revivagenix,http://click2hit.com/revivagenix,229,229,0
12:04:2014,revivasol,http://click2hit.com/revivasol,2243,2247,-4
12:04:2014,revolyn,http://click2hit.com/revolyn,215,215,0
12:04:2014,revoreplex,http://click2hit.com/revoreplex,4,209,-205
12:04:2014,rippedmusclex,http://click2hit.com/rippedmusclex,12,12,0
12:04:2014,rvtl,http://click2hit.com/rvtl,1913,1916,-3
12:04:2014,saphireecig,http://click2hit.com/saphireecig,593,594,-1
12:04:2014,secretbodybulk,http://click2hit.com/secretbodybulk,310,311,-1
12:04:2014,secretgarciniacambogia,http://click2hit.com/secretgarciniacambogia,249,250,-1
12:04:2014,secretlift,http://click2hit.com/secretlift,11,11,0
12:04:2014,sensa,http://click2hit.com/sensa,133,133,0
12:04:2014,simplycleanse,http://click2hit.com/simplycleanse,237,239,-2
12:04:2014,simplygarciniacambogia,http://click2hit.com/simplygarciniacambogia,442,444,-2
12:04:2014,simplygreencoffee,http://click2hit.com/simplygreencoffee,332,333,-1
12:04:2014,skinliftadvanced,http://click2hit.com/skinliftadvanced,222,222,0
12:04:2014,skinnyfiber,http://click2hit.com/skinnyfiber,398,398,0
12:04:2014,slendera-1,http://click2hit.com/slendera-1,40,43,-3
12:04:2014,slendera-sab,http://click2hit.com/slendera-sab,73,74,-1
12:04:2014,slimberrymax,http://click2hit.com/slimberrymax,258,259,-1
12:04:2014,slimbodycleanse,http://click2hit.com/slimbodycleanse,3119,3121,-2
12:04:2014,slimbodyketones,http://click2hit.com/slimbodyketones,152,161,-9
12:04:2014,slimcleanseplus,http://click2hit.com/slimcleanseplus,113,113,0
12:04:2014,slimlean,http://click2hit.com/slimlean,1038,1038,0
12:04:2014,slimnogym,http://click2hit.com/slimnogym,223,223,0
12:04:2014,slimtrimpm,http://click2hit.com/slimtrimpm,104,119,-15
12:04:2014,smileprodirect,http://click2hit.com/smileprodirect,3016,3039,-23
12:04:2014,solpria,http://click2hit.com/solpria,1087,1087,0
12:04:2014,sparkwhitening,http://click2hit.com/sparkwhitening,1604,1604,0
12:04:2014,strawberrygarciniacambogia,http://click2hit.com/strawberrygarciniacambogia,456,457,-1
12:04:2014,superbetaprostate,http://click2hit.com/superbetaprostate,152,152,0
12:04:2014,supercoloncleanse1800,http://click2hit.com/supercoloncleanse1800,290,290,0
12:04:2014,supergarciniacambogia,http://click2hit.com/supergarciniacambogia,1013,1030,-17
12:04:2014,superiorvelvet,http://click2hit.com/superiorvelvet,504,517,-13
12:04:2014,superketoneplus,http://click2hit.com/superketoneplus,4133,4155,-22
12:04:2014,superlean,http://click2hit.com/superlean,201,201,0
12:04:2014,superleancoloncleanse,http://click2hit.com/superleancoloncleanse,1348,1358,-10
12:04:2014,supertestoboost,http://click2hit.com/supertestoboost,134,134,0
12:04:2014,superyaconsyrup1000,http://click2hit.com/superyaconsyrup1000,24,24,0
12:04:2014,supracleanse350,http://click2hit.com/supracleanse350,849,875,-26
12:04:2014,supremeantler,http://click2hit.com/supremeantler,147,150,-3
12:04:2014,svelme,http://click2hit.com/svelme,46,46,0
12:04:2014,swolecreatinemuscle,http://click2hit.com/swolecreatinemuscle,186,186,0
12:04:2014,syneocell,http://click2hit.com/syneocell,189,189,0
12:04:2014,tadvance,http://click2hit.com/tadvance,473,473,0
12:04:2014,testabolancyp,http://click2hit.com/testabolancyp,343,343,0
12:04:2014,testocoreadvanced,http://click2hit.com/testocoreadvanced,326,334,-8
12:04:2014,testoforceedge,http://click2hit.com/testoforceedge,481,481,0
12:04:2014,testoforcex,http://click2hit.com/testoforcex,295,295,0
12:04:2014,testolimit,http://click2hit.com/testolimit,42,42,0
12:04:2014,testomax,http://click2hit.com/testomax,278,279,-1
12:04:2014,testoril,http://click2hit.com/testoril,523,524,-1
12:04:2014,testorushrx,http://click2hit.com/testorushrx,456,481,-25
12:04:2014,testoupmax,http://click2hit.com/testoupmax,142,146,-4
12:04:2014,testrx360,http://click2hit.com/testrx360,334,334,0
12:04:2014,testtoforcextreme,http://click2hit.com/testtoforcextreme,387,387,0
12:04:2014,testx180,http://click2hit.com/testx180,1422,1434,-12
12:04:2014,thermoblackx,http://click2hit.com/thermoblackx,142,142,0
12:04:2014,thermoextreme1,http://click2hit.com/thermoextreme1,570,570,0
12:04:2014,thermofactorx,http://click2hit.com/thermofactorx,821,822,-1
12:04:2014,thermosculptpro,http://click2hit.com/thermosculptpro,323,323,0
12:04:2014,titaniumprox,http://click2hit.com/titaniumprox,797,798,-1
12:04:2014,tlevelboost,http://click2hit.com/tlevelboost,65,66,-1
12:04:2014,tonaderm,http://click2hit.com/tonaderm,205,211,-6
12:04:2014,totalcleansecomplete,http://click2hit.com/totalcleansecomplete,390,396,-6
12:04:2014,trigx2,http://click2hit.com/trigx2,331,331,0
12:04:2014,trimextrin,http://click2hit.com/trimextrin,0,0,0
12:04:2014,truburnplus,http://click2hit.com/truburnplus,48,49,-1
12:04:2014,truecleansecomplete,http://click2hit.com/truecleansecomplete,223,228,-5
12:04:2014,turbofrce,http://click2hit.com/turbofrce,426,426,0
12:04:2014,ultracelebdiet,http://click2hit.com/ultracelebdiet,361,362,-1
12:04:2014,ultracleansepure,http://click2hit.com/ultracleansepure,3,3,0
12:04:2014,ultracoloncleanse,http://click2hit.com/ultracoloncleanse,45,45,0
12:04:2014,ultrafinesse,http://click2hit.com/ultrafinesse,86,90,-4
12:04:2014,ultragarciniacambogia,http://click2hit.com/ultragarciniacambogia,53,53,0
12:04:2014,ultramaxtestosterone,http://click2hit.com/ultramaxtestosterone,231,231,0
12:04:2014,ultraslim,http://click2hit.com/ultraslim,189,189,0
12:04:2014,umoris,http://click2hit.com/umoris,415,415,0
12:04:2014,vantage,http://click2hit.com/vantage,5,5,0
12:04:2014,vapexecig,http://click2hit.com/vapexecig,342,342,0
12:04:2014,vimaxdetox,http://click2hit.com/vimaxdetox,890,890,0
12:04:2014,virilityex,http://click2hit.com/virilityex,203,203,0
12:04:2014,vitaberryburn,http://click2hit.com/vitaberryburn,371,371,0
12:04:2014,vitaberrytrim,http://click2hit.com/vitaberrytrim,1818,1818,0
12:04:2014,vitacleanse,http://click2hit.com/vitacleanse,4666,4696,-30
12:04:2014,vitaketone,http://click2hit.com/vitaketone,963,966,-3
12:04:2014,vitalcleanse,http://click2hit.com/vitalcleanse,181,182,-1
12:04:2014,vitalcleansecomplete,http://click2hit.com/vitalcleansecomplete,765,766,-1
12:04:2014,vitalifedetox,http://click2hit.com/vitalifedetox,744,744,0
12:04:2014,vitalikortest,http://click2hit.com/vitalikortest,603,607,-4
12:04:2014,vitalipo,http://click2hit.com/vitalipo,123,123,0
12:04:2014,vitalitygreencoffee,http://click2hit.com/vitalitygreencoffee,197,197,0
12:04:2014,vitamaxgarciniacambogia,http://click2hit.com/vitamaxgarciniacambogia,1850,1863,-13
12:04:2014,vyalis,http://click2hit.com/vyalis,238,239,-1
12:04:2014,wrinklerewind,http://click2hit.com/wrinklerewind,5785,5793,-8
12:04:2014,xmrecovery,http://click2hit.com/xmrecovery,148,149,-1
12:04:2014,xtremegarciniacambogia,http://click2hit.com/xtremegarciniacambogia,485,485,0
12:04:2014,xtremenitro,http://click2hit.com/xtremenitro,61,64,-3
12:04:2014,xtremetestosteronebooster,http://click2hit.com/xtremetestosteronebooster,367,369,-2
12:04:2014,yaconmolasses,http://click2hit.com/yaconmolasses,82,83,-1
12:04:2014,yaconrootmax,http://click2hit.com/yaconrootmax,1436,1644,-208
12:04:2014,yaconsyrupdirect,http://click2hit.com/yaconsyrupdirect,219,219,0
12:04:2014,yolosleep,http://click2hit.com/yolosleep,213,214,-1
12:04:2014,youthkitantiaging,http://click2hit.com/youthkitantiaging,199,199,0
12:04:2014,zenacose,http://click2hit.com/zenacose,164,164,0
12:04:2014,zenscleanse,http://click2hit.com/zenscleanse,2660,2672,-12
12:04:2014,zinncollection,http://click2hit.com/zinncollection,180,180,0
12:04:2014,zolyria,http://click2hit.com/zolyria,509,511,-2
12:04:2014,zyloslim,http://click2hit.com/zyloslim,3774,3791,-17
12:04:2014,zymbiotix,http://click2hit.com/zymbiotix,1295,1305,-10
