dt_today,sitetitle,sitelink,pre_click,new_clicks,difrnce
07:04:2014,5stargarciniacambogia,http://click2hit.com/5stargarciniacambogia,85,86,-1
07:04:2014,Adrenalast,http://click2hit.com/Adrenalast,546,547,-1
07:04:2014,Anataflex,http://click2hit.com/Anataflex,1293,1293,0
07:04:2014,Diabetix,http://click2hit.com/Diabetix,725,725,0
07:04:2014,Equinox,http://click2hit.com/Equinox,8591,8603,-12
07:04:2014,LuxeCoat,http://click2hit.com/LuxeCoat,411,412,-1
07:04:2014,NOX360,http://click2hit.com/NOX360,52,52,0
07:04:2014,Prescopodene,http://click2hit.com/Prescopodene,1352,1356,-4
07:04:2014,Puregarciniaslim,http://click2hit.com/Puregarciniaslim,173,343,-170
07:04:2014,RevoReplex,http://click2hit.com/RevoReplex,206,4,202
07:04:2014,absoluteraspberryketone,http://click2hit.com/absoluteraspberryketone,8,8,0
07:04:2014,acaiberrypuremax,http://click2hit.com/acaiberrypuremax,172,174,-2
07:04:2014,actionprowhite,http://click2hit.com/actionprowhite,67,68,-1
07:04:2014,activedetoxcleanse,http://click2hit.com/activedetoxcleanse,26,29,-3
07:04:2014,activeraspberryketone,http://click2hit.com/activeraspberryketone,57,72,-15
07:04:2014,advancedgarciniacambogia,http://click2hit.com/advancedgarciniacambogia,778,778,0
07:04:2014,advancedpuregarcinia,http://click2hit.com/advancedpuregarcinia,552,552,0
07:04:2014,advancedtest,http://click2hit.com/advancedtest,571,571,0
07:04:2014,advancedtrimgreencoffee,http://click2hit.com/advancedtrimgreencoffee,1672,1672,0
07:04:2014,africanmangopremier,http://click2hit.com/africanmangopremier,742,743,-1
07:04:2014,agelesshealthsolution,http://click2hit.com/agelesshealthsolution,122,122,0
07:04:2014,alleureantiagingcream,http://click2hit.com/alleureantiagingcream,159,192,-33
07:04:2014,alleureeyeserum,http://click2hit.com/alleureeyeserum,171,220,-49
07:04:2014,aloeferoxcleanse,http://click2hit.com/aloeferoxcleanse,1298,1308,-10
07:04:2014,aloeveracleanse,http://click2hit.com/aloeveracleanse,641,642,-1
07:04:2014,alore,http://click2hit.com/alore,3888,3904,-16
07:04:2014,alphacuthd,http://click2hit.com/alphacuthd,43,44,-1
07:04:2014,alphagenix,http://click2hit.com/alphagenix,33,47,-14
07:04:2014,alphamale,http://click2hit.com/alphamale,197,197,0
07:04:2014,alphamax1,http://click2hit.com/alphamax1,250,254,-4
07:04:2014,amacari,http://click2hit.com/amacari,152,153,-1
07:04:2014,amazingcleanse,http://click2hit.com/amazingcleanse,2,2,0
07:04:2014,ambitrimrx,http://click2hit.com/ambitrimrx,772,772,0
07:04:2014,amino,http://click2hit.com/amino,1269,1270,-1
07:04:2014,andromale,http://click2hit.com/andromale,532,534,-2
07:04:2014,anoradrol,http://click2hit.com/anoradrol,85,85,0
07:04:2014,aussiegarciniacambogia,http://click2hit.com/aussiegarciniacambogia,157,157,0
07:04:2014,authenticgarciniacambogia,http://click2hit.com/authenticgarciniacambogia,68,71,-3
07:04:2014,beaute,http://click2hit.com/beaute,645,646,-1
07:04:2014,bellaathome,http://click2hit.com/bellaathome,1757,1758,-1
07:04:2014,bellapure,http://click2hit.com/bellapure,1713,1724,-11
07:04:2014,bellecomplex,http://click2hit.com/bellecomplex,640,640,0
07:04:2014,berryherbalcleanse,http://click2hit.com/berryherbalcleanse,571,572,-1
07:04:2014,berrythingarciniacambogia,http://click2hit.com/berrythingarciniacambogia,540,540,0
07:04:2014,betaalalinemax,http://click2hit.com/betaalalinemax,570,570,0
07:04:2014,betaboost,http://click2hit.com/betaboost,108,108,0
07:04:2014,betaforce,http://click2hit.com/betaforce,654,654,0
07:04:2014,beyondraspberryketone,http://click2hit.com/beyondraspberryketone,2099,2099,0
07:04:2014,biocareslimplus,http://click2hit.com/biocareslimplus,312,312,0
07:04:2014,biocarexl,http://click2hit.com/biocarexl,326,326,0
07:04:2014,biogeniste,http://click2hit.com/biogeniste,448,448,0
07:04:2014,blackbullmaleenhancement,http://click2hit.com/blackbullmaleenhancement,1453,1456,-3
07:04:2014,blackdiamond,http://click2hit.com/blackdiamond,431,447,-16
07:04:2014,blacklineelite,http://click2hit.com/blacklineelite,1447,1471,-24
07:04:2014,blastxl,http://click2hit.com/blastxl,143,143,0
07:04:2014,blizzadwhite,http://click2hit.com/blizzadwhite,20,21,-1
07:04:2014,bluemagicplus,http://click2hit.com/bluemagicplus,869,869,0
07:04:2014,bodyfuelxs,http://click2hit.com/bodyfuelxs,89,89,0
07:04:2014,brandnew,http://click2hit.com/brandnew,351,351,0
07:04:2014,brandnewbooty,http://click2hit.com/brandnewbooty,770,770,0
07:04:2014,cafevertextraminceur,http://click2hit.com/cafevertextraminceur,2190,2266,-76
07:04:2014,carbuloss,http://click2hit.com/carbuloss,358,363,-5
07:04:2014,celebritybodynow,http://click2hit.com/celebritybodynow,420,422,-2
07:04:2014,celebrityweightlosskit,http://click2hit.com/celebrityweightlosskit,360,360,0
07:04:2014,cellanafricanmango,http://click2hit.com/cellanafricanmango,1950,2035,-85
07:04:2014,cellogicaskin,http://click2hit.com/cellogicaskin,179,183,-4
07:04:2014,cenaless,http://click2hit.com/cenaless,75,75,0
07:04:2014,cenaslim,http://click2hit.com/cenaslim,385,387,-2
07:04:2014,cleandetox,http://click2hit.com/cleandetox,270,270,0
07:04:2014,cleansecatalystplus,http://click2hit.com/cleansecatalystplus,3312,3323,-11
07:04:2014,cleanseultimo,http://click2hit.com/cleanseultimo,1406,1406,0
07:04:2014,cocogeniceyeserum,http://click2hit.com/cocogeniceyeserum,10,10,0
07:04:2014,coffeecleansemax,http://click2hit.com/coffeecleansemax,384,387,-3
07:04:2014,coffeepurecleanse,http://click2hit.com/coffeepurecleanse,52,52,0
07:04:2014,coleanse,http://click2hit.com/coleanse,2079,2085,-6
07:04:2014,collagen,http://click2hit.com/collagen,12,18,-6
07:04:2014,collagenfaceserum,http://click2hit.com/collagenfaceserum,46,49,-3
07:04:2014,colodetox,http://click2hit.com/colodetox,531,531,0
07:04:2014,colodetoxplus,http://click2hit.com/colodetoxplus,92,92,0
07:04:2014,coloncleanse1300,http://click2hit.com/coloncleanse1300,283,283,0
07:04:2014,coloncleansecomplete,http://click2hit.com/coloncleansecomplete,1293,1296,-3
07:04:2014,coloncleansetotal,http://click2hit.com/coloncleansetotal,767,767,0
07:04:2014,colondetoxpro,http://click2hit.com/colondetoxpro,31,33,-2
07:04:2014,colonpurecleanse,http://click2hit.com/colonpurecleanse,417,419,-2
07:04:2014,colothin,http://click2hit.com/colothin,190,192,-2
07:04:2014,columbiangreencoffeebean,http://click2hit.com/columbiangreencoffeebean,742,746,-4
07:04:2014,combogiaplus,http://click2hit.com/combogiaplus,329,331,-2
07:04:2014,completecoffeecleanse,http://click2hit.com/completecoffeecleanse,395,395,0
07:04:2014,complexiderm,http://click2hit.com/complexiderm,187,187,0
07:04:2014,cosimarevival,http://click2hit.com/cosimarevival,182,182,0
07:04:2014,cosmitone,http://click2hit.com/cosmitone,1331,1332,-1
07:04:2014,csorex,http://click2hit.com/csorex,107,107,0
07:04:2014,curcovia,http://click2hit.com/curcovia,425,425,0
07:04:2014,cutiecurves,http://click2hit.com/cutiecurves,246,246,0
07:04:2014,cytotrim,http://click2hit.com/cytotrim,2,2,0
07:04:2014,dailyeyerestoration,http://click2hit.com/dailyeyerestoration,142,143,-1
07:04:2014,dellure,http://click2hit.com/dellure,118,118,0
07:04:2014,dellurecollagen,http://click2hit.com/dellurecollagen,570,570,0
07:04:2014,dermafirm,http://click2hit.com/dermafirm,759,760,-1
07:04:2014,dermajuvenate,http://click2hit.com/dermajuvenate,2309,2316,-7
07:04:2014,dermalift,http://click2hit.com/dermalift,235,235,0
07:04:2014,dermallo,http://click2hit.com/dermallo,269,269,0
07:04:2014,dermalmeds,http://click2hit.com/dermalmeds,444,446,-2
07:04:2014,dermangelie,http://click2hit.com/dermangelie,155,155,0
07:04:2014,derminelift,http://click2hit.com/derminelift,403,403,0
07:04:2014,dermology,http://click2hit.com/dermology,42,42,0
07:04:2014,detoxmax,http://click2hit.com/detoxmax,53,56,-3
07:04:2014,dietultimo,http://click2hit.com/dietultimo,2510,2514,-4
07:04:2014,digestItcoloncleanse,http://click2hit.com/digestItcoloncleanse,61,61,0
07:04:2014,duplicellp199,http://click2hit.com/duplicellp199,35,40,-5
07:04:2014,duplicellp199facetherapy,http://click2hit.com/duplicellp199facetherapy,35,41,-6
07:04:2014,ecoflex,http://click2hit.com/ecoflex,126,126,0
07:04:2014,electravx,http://click2hit.com/electravx,179,179,0
07:04:2014,elevategf,http://click2hit.com/elevategf,266,266,0
07:04:2014,elite360,http://click2hit.com/elite360,68,68,0
07:04:2014,elliskin,http://click2hit.com/elliskin,503,503,0
07:04:2014,endorev,http://click2hit.com/endorev,461,462,-1
07:04:2014,ephedrix,http://click2hit.com/ephedrix,227,227,0
07:04:2014,equivita,http://click2hit.com/equivita,7762,7797,-35
07:04:2014,essentialdetox,http://click2hit.com/essentialdetox,427,427,0
07:04:2014,extagen,http://click2hit.com/extagen,332,332,0
07:04:2014,extremefx,http://click2hit.com/extremefx,340,347,-7
07:04:2014,eyeluminous,http://click2hit.com/eyeluminous,587,603,-16
07:04:2014,fembalance,http://click2hit.com/fembalance,362,362,0
07:04:2014,firmativ,http://click2hit.com/firmativ,775,804,-29
07:04:2014,flawlessbeauty,http://click2hit.com/flawlessbeauty,101,104,-3
07:04:2014,flexwell,http://click2hit.com/flexwell,102,102,0
07:04:2014,forceeffect,http://click2hit.com/forceeffect,187,235,-48
07:04:2014,formularezvmagic,http://click2hit.com/formularezvmagic,231,231,0
07:04:2014,fortdietmax,http://click2hit.com/fortdietmax,80,80,0
07:04:2014,fortmaxdiet,http://click2hit.com/fortmaxdiet,72,73,-1
07:04:2014,garciniaberrythin,http://click2hit.com/garciniaberrythin,477,477,0
07:04:2014,garciniacambogia1300,http://click2hit.com/garciniacambogia1300,659,659,0
07:04:2014,garciniacambogia360,http://click2hit.com/garciniacambogia360,13,15,-2
07:04:2014,garciniacambogia500,http://click2hit.com/garciniacambogia500,3,3,0
07:04:2014,garciniacambogiablast,http://click2hit.com/garciniacambogiablast,731,747,-16
07:04:2014,garciniacambogiaburn,http://click2hit.com/garciniacambogiaburn,93,94,-1
07:04:2014,garciniacambogiacomplex,http://click2hit.com/garciniacambogiacomplex,329,331,-2
07:04:2014,garciniacambogiaextract,http://click2hit.com/garciniacambogiaextract,48,48,0
07:04:2014,garciniacambogiafit1300,http://click2hit.com/garciniacambogiafit1300,128,128,0
07:04:2014,garciniacambogiaformula,http://click2hit.com/garciniacambogiaformula,30,34,-4
07:04:2014,garciniacambogiahca,http://click2hit.com/garciniacambogiahca,3,3,0
07:04:2014,garciniacambogiaplus,http://click2hit.com/garciniacambogiaplus,1133,1133,0
07:04:2014,garciniacambogiapro,http://click2hit.com/garciniacambogiapro,16,16,0
07:04:2014,garciniacambogiaselect,http://click2hit.com/garciniacambogiaselect,489,489,0
07:04:2014,garciniacambogiaslimfast,http://click2hit.com/garciniacambogiaslimfast,1786,1786,0
07:04:2014,garciniacambogiaslimsystem,http://click2hit.com/garciniacambogiaslimsystem,1100,1106,-6
07:04:2014,garciniacambogiaxt,http://click2hit.com/garciniacambogiaxt,151,161,-10
07:04:2014,garciniacambogiaz,http://click2hit.com/garciniacambogiaz,1,2,-1
07:04:2014,garciniacombogiasupreme,http://click2hit.com/garciniacombogiasupreme,23,23,0
07:04:2014,garciniadietmax,http://click2hit.com/garciniadietmax,322,328,-6
07:04:2014,garciniaextractplus,http://click2hit.com/garciniaextractplus,231,231,0
07:04:2014,garciniaforte,http://click2hit.com/garciniaforte,4,4,0
07:04:2014,garciniahca,http://click2hit.com/garciniahca,139,139,0
07:04:2014,garciniahcapremium,http://click2hit.com/garciniahcapremium,96,100,-4
07:04:2014,garciniaplus,http://click2hit.com/garciniaplus,1972,1977,-5
07:04:2014,garciniasuperdiet,http://click2hit.com/garciniasuperdiet,172,172,0
07:04:2014,garciniawonder,http://click2hit.com/garciniawonder,804,808,-4
07:04:2014,garciniawow,http://click2hit.com/garciniawow,85,85,0
07:04:2014,garciniaxslim,http://click2hit.com/garciniaxslim,506,513,-7
07:04:2014,gc180xt,http://click2hit.com/gc180xt,550,552,-2
07:04:2014,gcbmaxgreencoffee,http://click2hit.com/gcbmaxgreencoffee,342,343,-1
07:04:2014,gcfitsgarcinia,http://click2hit.com/gcfitsgarcinia,5,5,0
07:04:2014,gcxsdiet,http://click2hit.com/gcxsdiet,36,37,-1
07:04:2014,genesis,http://click2hit.com/genesis,42,42,0
07:04:2014,gogiberryburn,http://click2hit.com/gogiberryburn,19,20,-1
07:04:2014,gojiactives,http://click2hit.com/gojiactives,1478,1492,-14
07:04:2014,gojiadvance,http://click2hit.com/gojiadvance,381,382,-1
07:04:2014,gojimax,http://click2hit.com/gojimax,239,242,-3
07:04:2014,gojislim,http://click2hit.com/gojislim,20169,20191,-22
07:04:2014,govapor,http://click2hit.com/govapor,94,104,-10
07:04:2014,greencoffeebeanthin,http://click2hit.com/greencoffeebeanthin,282,282,0
07:04:2014,greencoffeebody,http://click2hit.com/greencoffeebody,415,415,0
07:04:2014,greencoffeecleanse,http://click2hit.com/greencoffeecleanse,17,18,-1
07:04:2014,greencoffeecleanse1,http://click2hit.com/greencoffeecleanse1,26,27,-1
07:04:2014,greencoffeecleanses,http://click2hit.com/greencoffeecleanses,772,805,-33
07:04:2014,greencoffeeextraslim,http://click2hit.com/greencoffeeextraslim,272,272,0
07:04:2014,greencoffeefatburn,http://click2hit.com/greencoffeefatburn,1563,1565,-2
07:04:2014,greencoffeenaxx,http://click2hit.com/greencoffeenaxx,194,194,0
07:04:2014,greencoffeeplus,http://click2hit.com/greencoffeeplus,101,101,0
07:04:2014,greencoffeeprogram,http://click2hit.com/greencoffeeprogram,54,55,-1
07:04:2014,greencoffeerevolution,http://click2hit.com/greencoffeerevolution,24,24,0
07:04:2014,greencoffeespeedslim,http://click2hit.com/greencoffeespeedslim,1334,1371,-37
07:04:2014,greencoffeesupreme,http://click2hit.com/greencoffeesupreme,345,347,-2
07:04:2014,greencoffeesupremecleanse,http://click2hit.com/greencoffeesupremecleanse,117,118,-1
07:04:2014,greendetoxpatch,http://click2hit.com/greendetoxpatch,283,283,0
07:04:2014,greenleancoffeebean,http://click2hit.com/greenleancoffeebean,206,207,-1
07:04:2014,greentonepromuscle,http://click2hit.com/greentonepromuscle,213,213,0
07:04:2014,growxl,http://click2hit.com/growxl,2710,2712,-2
07:04:2014,hairgenesis,http://click2hit.com/hairgenesis,79,79,0
07:04:2014,hardknight,http://click2hit.com/hardknight,1433,1433,0
07:04:2014,hardknight-1,http://click2hit.com/hardknight-1,82,83,-1
07:04:2014,hawaiislim,http://click2hit.com/hawaiislim,140,140,0
07:04:2014,healthycleanse,http://click2hit.com/healthycleanse,512,513,-1
07:04:2014,heboost,http://click2hit.com/heboost,235,235,0
07:04:2014,hghfuel,http://click2hit.com/hghfuel,23,24,-1
07:04:2014,hghpro,http://click2hit.com/hghpro,11,13,-2
07:04:2014,hghxl,http://click2hit.com/hghxl,135,135,0
07:04:2014,hight,http://click2hit.com/hight,324,324,0
07:04:2014,hspactives,http://click2hit.com/hspactives,2154,2157,-3
07:04:2014,htrush,http://click2hit.com/htrush,300,301,-1
07:04:2014,hydradiance,http://click2hit.com/hydradiance,514,531,-17
07:04:2014,hydrafirm,http://click2hit.com/hydrafirm,253,255,-2
07:04:2014,hydravella,http://click2hit.com/hydravella,226,226,0
07:04:2014,hydroface,http://click2hit.com/hydroface,618,618,0
07:04:2014,hydroxatone90,http://click2hit.com/hydroxatone90,322,322,0
07:04:2014,hydroxatonebbcream,http://click2hit.com/hydroxatonebbcream,72,73,-1
07:04:2014,idolize,http://click2hit.com/idolize,110,123,-13
07:04:2014,instaleanketones,http://click2hit.com/instaleanketones,695,695,0
07:04:2014,instantderma,http://click2hit.com/instantderma,185,185,0
07:04:2014,instantlift,http://click2hit.com/instantlift,471,471,0
07:04:2014,juvalife,http://click2hit.com/juvalife,88,88,0
07:04:2014,juvamend,http://click2hit.com/juvamend,0,1,-1
07:04:2014,juvesiio,http://click2hit.com/juvesiio,56,56,0
07:04:2014,ketoneadvanced,http://click2hit.com/ketoneadvanced,87,100,-13
07:04:2014,ketonepremium,http://click2hit.com/ketonepremium,529,529,0
07:04:2014,kollagen,http://click2hit.com/kollagen,78,79,-1
07:04:2014,l-carnitineplus,http://click2hit.com/l-carnitineplus,145,147,-2
07:04:2014,ladermanique,http://click2hit.com/ladermanique,1720,1723,-3
07:04:2014,larginineplus,http://click2hit.com/larginineplus,30,30,0
07:04:2014,leanmusclex,http://click2hit.com/leanmusclex,6,6,0
07:04:2014,leptizin,http://click2hit.com/leptizin,103,103,0
07:04:2014,lifecell,http://click2hit.com/lifecell,140,140,0
07:04:2014,liftandglowpro,http://click2hit.com/liftandglowpro,36,36,0
07:04:2014,liftderma,http://click2hit.com/liftderma,758,760,-2
07:04:2014,liftserumpro,http://click2hit.com/liftserumpro,53,54,-1
07:04:2014,liftvapor,http://click2hit.com/liftvapor,894,894,0
07:04:2014,lipo13,http://click2hit.com/lipo13,890,923,-33
07:04:2014,lipog3,http://click2hit.com/lipog3,380,434,-54
07:04:2014,liposlim,http://click2hit.com/liposlim,211,211,0
07:04:2014,lisocleanse,http://click2hit.com/lisocleanse,109,137,-28
07:04:2014,lorelia,http://click2hit.com/lorelia,2095,2114,-19
07:04:2014,lumeraeyeserum,http://click2hit.com/lumeraeyeserum,2226,2242,-16
07:04:2014,luminant,http://click2hit.com/luminant,396,396,0
07:04:2014,luminantskin,http://click2hit.com/luminantskin,411,412,-1
07:04:2014,luminique,http://click2hit.com/luminique,83,84,-1
07:04:2014,luministeyegel,http://click2hit.com/luministeyegel,209,209,0
07:04:2014,lunarsleep,http://click2hit.com/lunarsleep,265,272,-7
07:04:2014,lunathin,http://click2hit.com/lunathin,142,142,0
07:04:2014,lxwpro-t,http://click2hit.com/lxwpro-t,22,24,-2
07:04:2014,lysocleanse,http://click2hit.com/lysocleanse,764,768,-4
07:04:2014,massivevitality,http://click2hit.com/massivevitality,28,28,0
07:04:2014,masspmnight,http://click2hit.com/masspmnight,38,38,0
07:04:2014,maxburncambogia,http://click2hit.com/maxburncambogia,6900,6904,-4
07:04:2014,maxcleanse,http://click2hit.com/maxcleanse,273,273,0
07:04:2014,maxdetox,http://click2hit.com/maxdetox,376,376,0
07:04:2014,maxgarciniaburn,http://click2hit.com/maxgarciniaburn,260,260,0
07:04:2014,maxleanx,http://click2hit.com/maxleanx,279,279,0
07:04:2014,maxlight,http://click2hit.com/maxlight,11,11,0
07:04:2014,maxmuscleblast,http://click2hit.com/maxmuscleblast,35,38,-3
07:04:2014,maxmusclelean,http://click2hit.com/maxmusclelean,47,47,0
07:04:2014,maxtrimraspberryketone,http://click2hit.com/maxtrimraspberryketone,107,107,0
07:04:2014,maxxmale,http://click2hit.com/maxxmale,183,183,0
07:04:2014,maxxtest300,http://click2hit.com/maxxtest300,25,25,0
07:04:2014,miraclegarciniacambogia1300,http://click2hit.com/miraclegarciniacambogia1300,50,52,-2
07:04:2014,miraclegarciniacambogiarx,http://click2hit.com/miraclegarciniacambogiarx,57,63,-6
07:04:2014,miraclephytoceramides,http://click2hit.com/miraclephytoceramides,2162,2183,-21
07:04:2014,miracleraspberryketone,http://click2hit.com/miracleraspberryketone,26,27,-1
07:04:2014,mitoslim,http://click2hit.com/mitoslim,749,749,0
07:04:2014,mizulean,http://click2hit.com/mizulean,245,245,0
07:04:2014,musclecorex,http://click2hit.com/musclecorex,514,514,0
07:04:2014,muscleforcex,http://click2hit.com/muscleforcex,89,89,0
07:04:2014,musclekingpro,http://click2hit.com/musclekingpro,303,303,0
07:04:2014,musclemax,http://click2hit.com/musclemax,227,228,-1
07:04:2014,muscleripx,http://click2hit.com/muscleripx,211,212,-1
07:04:2014,musclexedge,http://click2hit.com/musclexedge,525,526,-1
07:04:2014,musclexpro,http://click2hit.com/musclexpro,96,98,-2
07:04:2014,musclezx90,http://click2hit.com/musclezx90,2905,2906,-1
07:04:2014,naturalburn,http://click2hit.com/naturalburn,258,258,0
07:04:2014,naturalcleanse,http://click2hit.com/naturalcleanse,812,812,0
07:04:2014,naturalcoloncleanseelite,http://click2hit.com/naturalcoloncleanseelite,318,322,-4
07:04:2014,naturaldiet,http://click2hit.com/naturaldiet,146,147,-1
07:04:2014,naturalgarciniacambogiaburn,http://click2hit.com/naturalgarciniacambogiaburn,236,240,-4
07:04:2014,naturalgreencleanse,http://click2hit.com/naturalgreencleanse,547,549,-2
07:04:2014,naturalgreencoffeeburn,http://click2hit.com/naturalgreencoffeeburn,423,423,0
07:04:2014,naturalpluscleanse,http://click2hit.com/naturalpluscleanse,129,129,0
07:04:2014,naturalpurecleanse,http://click2hit.com/naturalpurecleanse,393,394,-1
07:04:2014,neucleanseultimate,http://click2hit.com/neucleanseultimate,430,435,-5
07:04:2014,neugarciniacambogia,http://click2hit.com/neugarciniacambogia,15,16,-1
07:04:2014,neuropathysupportformula,http://click2hit.com/neuropathysupportformula,246,247,-1
07:04:2014,newagecleanse,http://click2hit.com/newagecleanse,329,330,-1
07:04:2014,newlifecleanse,http://click2hit.com/newlifecleanse,156,157,-1
07:04:2014,nidora,http://click2hit.com/nidora,512,542,-30
07:04:2014,nitricmaxmuscle,http://click2hit.com/nitricmaxmuscle,319,319,0
07:04:2014,nitricmaxmuscle1,http://click2hit.com/nitricmaxmuscle1,62,62,0
07:04:2014,nitricpower,http://click2hit.com/nitricpower,8,11,-3
07:04:2014,nitroxin,http://click2hit.com/nitroxin,30,30,0
07:04:2014,nitroxl,http://click2hit.com/nitroxl,282,282,0
07:04:2014,nitroxpro,http://click2hit.com/nitroxpro,6459,6573,-114
07:04:2014,no2explodeextreme,http://click2hit.com/no2explodeextreme,1492,1497,-5
07:04:2014,no2factor,http://click2hit.com/no2factor,330,330,0
07:04:2014,no2maximus,http://click2hit.com/no2maximus,2372,2386,-14
07:04:2014,no2surge,http://click2hit.com/no2surge,233,261,-28
07:04:2014,nuetrim,http://click2hit.com/nuetrim,429,429,0
07:04:2014,nutraburn10,http://click2hit.com/nutraburn10,95,95,0
07:04:2014,nutranaturalgarciniacambogia,http://click2hit.com/nutranaturalgarciniacambogia,115,117,-2
07:04:2014,nutridiet,http://click2hit.com/nutridiet,992,1026,-34
07:04:2014,nuvagenic,http://click2hit.com/nuvagenic,197,197,0
07:04:2014,nuvie,http://click2hit.com/nuvie,157,160,-3
07:04:2014,nuvocleanse,http://click2hit.com/nuvocleanse,591,591,0
07:04:2014,nuvoslim,http://click2hit.com/nuvoslim,392,403,-11
07:04:2014,onemoment,http://click2hit.com/onemoment,128,147,-19
07:04:2014,optimalstack,http://click2hit.com/optimalstack,463,467,-4
07:04:2014,organiccleanse,http://click2hit.com/organiccleanse,3,3,0
07:04:2014,organiccleansedetox,http://click2hit.com/organiccleansedetox,58,63,-5
07:04:2014,organicgarciniacambogia,http://click2hit.com/organicgarciniacambogia,195,195,0
07:04:2014,originalgarciniacambogia,http://click2hit.com/originalgarciniacambogia,48,53,-5
07:04:2014,originalyaconextract,http://click2hit.com/originalyaconextract,152,152,0
07:04:2014,originalyaconsyrup,http://click2hit.com/originalyaconsyrup,56,57,-1
07:04:2014,orvigomax,http://click2hit.com/orvigomax,50,65,-15
07:04:2014,ourgreencleanse,http://click2hit.com/ourgreencleanse,147,147,0
07:04:2014,oxygenius,http://click2hit.com/oxygenius,1340,1356,-16
07:04:2014,pelevoni,http://click2hit.com/pelevoni,320,320,0
07:04:2014,platinumgarciniacambogia,http://click2hit.com/platinumgarciniacambogia,355,356,-1
07:04:2014,poshcream,http://click2hit.com/poshcream,24,25,-1
07:04:2014,powermax,http://click2hit.com/powermax,8,8,0
07:04:2014,powerprecision,http://click2hit.com/powerprecision,118,118,0
07:04:2014,poweruphealthgarcinia,http://click2hit.com/poweruphealthgarcinia,124,145,-21
07:04:2014,premiermangocleanse,http://click2hit.com/premiermangocleanse,204,204,0
07:04:2014,premiumgarciniacambogiaslim,http://click2hit.com/premiumgarciniacambogiaslim,98,120,-22
07:04:2014,premiumgreencoffeebean,http://click2hit.com/premiumgreencoffeebean,207,207,0
07:04:2014,procollagen,http://click2hit.com/procollagen,266,266,0
07:04:2014,procoloncleanse,http://click2hit.com/procoloncleanse,168,168,0
07:04:2014,prodermagenix,http://click2hit.com/prodermagenix,187,188,-1
07:04:2014,prodermagenixplus,http://click2hit.com/prodermagenixplus,257,257,0
07:04:2014,progain350,http://click2hit.com/progain350,3,3,0
07:04:2014,prolong,http://click2hit.com/prolong,592,618,-26
07:04:2014,prolongz,http://click2hit.com/prolongz,438,453,-15
07:04:2014,promusclecomplex,http://click2hit.com/promusclecomplex,539,539,0
07:04:2014,pronutragarcinia,http://click2hit.com/pronutragarcinia,54,55,-1
07:04:2014,protrim,http://click2hit.com/protrim,1046,1046,0
07:04:2014,purafit,http://click2hit.com/purafit,364,364,0
07:04:2014,puragreencoffee,http://click2hit.com/puragreencoffee,287,288,-1
07:04:2014,pureberrymax,http://click2hit.com/pureberrymax,268,268,0
07:04:2014,purebiodiet,http://click2hit.com/purebiodiet,648,648,0
07:04:2014,purecambogiaultra,http://click2hit.com/purecambogiaultra,190,201,-11
07:04:2014,purecambogiaultra-1,http://click2hit.com/purecambogiaultra-1,591,594,-3
07:04:2014,purecambogiaultra2,http://click2hit.com/purecambogiaultra2,172,176,-4
07:04:2014,purecleanse,http://click2hit.com/purecleanse,500,500,0
07:04:2014,purecleansemax,http://click2hit.com/purecleansemax,235,235,0
07:04:2014,purecolocleanse,http://click2hit.com/purecolocleanse,265,265,0
07:04:2014,purecoloncleanser,http://click2hit.com/purecoloncleanser,1548,1555,-7
07:04:2014,puregarciniacambogia,http://click2hit.com/puregarciniacambogia,195,195,0
07:04:2014,puregarciniacambogia-1,http://click2hit.com/puregarciniacambogia-1,7618,7682,-64
07:04:2014,puregarciniacambogiaburn,http://click2hit.com/puregarciniacambogiaburn,2326,2327,-1
07:04:2014,puregarciniacambogiaplus,http://click2hit.com/puregarciniacambogiaplus,373,375,-2
07:04:2014,puregarciniacambogiapremium,http://click2hit.com/puregarciniacambogiapremium,1219,1226,-7
07:04:2014,puregarciniacambogiaslim,http://click2hit.com/puregarciniacambogiaslim,891,891,0
07:04:2014,puregarciniacambogiaslimsystem,http://click2hit.com/puregarciniacambogiaslimsystem,252,252,0
07:04:2014,puregarciniacanada,http://click2hit.com/puregarciniacanada,54,55,-1
07:04:2014,puregarciniaelite,http://click2hit.com/puregarciniaelite,31,31,0
07:04:2014,puregarciniaslim,http://click2hit.com/puregarciniaslim,343,173,170
07:04:2014,puregarciniaultra,http://click2hit.com/puregarciniaultra,520,522,-2
07:04:2014,puregarciniaultra-1,http://click2hit.com/puregarciniaultra-1,134,134,0
07:04:2014,puregreencoffee,http://click2hit.com/puregreencoffee,420,420,0
07:04:2014,puregreencoffeebeanplus,http://click2hit.com/puregreencoffeebeanplus,12,17,-5
07:04:2014,purelifecleanse1,http://click2hit.com/purelifecleanse1,305,400,-95
07:04:2014,purenitrate,http://click2hit.com/purenitrate,79,81,-2
07:04:2014,purenitromax,http://click2hit.com/purenitromax,490,491,-1
07:04:2014,purensa,http://click2hit.com/purensa,1655,1661,-6
07:04:2014,pureraspberryketonepremium,http://click2hit.com/pureraspberryketonepremium,234,235,-1
07:04:2014,puressance,http://click2hit.com/puressance,124,124,0
07:04:2014,purestgarciniacambogia,http://click2hit.com/purestgarciniacambogia,19,19,0
07:04:2014,pureyaconsyrupextract,http://click2hit.com/pureyaconsyrupextract,255,255,0
07:04:2014,pureyaconsyrupplus,http://click2hit.com/pureyaconsyrupplus,146,149,-3
07:04:2014,pureyaconxt,http://click2hit.com/pureyaconxt,72,73,-1
07:04:2014,px800greencoffee,http://click2hit.com/px800greencoffee,56,57,-1
07:04:2014,quickgreencoffee,http://click2hit.com/quickgreencoffee,394,395,-1
07:04:2014,raspberryketonefresh,http://click2hit.com/raspberryketonefresh,1061,1061,0
07:04:2014,raspberryketoneproslim,http://click2hit.com/raspberryketoneproslim,304,311,-7
07:04:2014,raspberryketones,http://click2hit.com/raspberryketones,321,321,0
07:04:2014,raspberryslimplus,http://click2hit.com/raspberryslimplus,178,178,0
07:04:2014,raspberrytones,http://click2hit.com/raspberrytones,359,359,0
07:04:2014,raspberrytrim,http://click2hit.com/raspberrytrim,148,149,-1
07:04:2014,raspberryultraketone,http://click2hit.com/raspberryultraketone,198,199,-1
07:04:2014,rawburn,http://click2hit.com/rawburn,145,145,0
07:04:2014,regularx,http://click2hit.com/regularx,91,97,-6
07:04:2014,rejouvance,http://click2hit.com/rejouvance,480,480,0
07:04:2014,rejuvaglow,http://click2hit.com/rejuvaglow,65,65,0
07:04:2014,rejuvalash,http://click2hit.com/rejuvalash,254,255,-1
07:04:2014,rejuvalskin,http://click2hit.com/rejuvalskin,24,29,-5
07:04:2014,rejuvenex,http://click2hit.com/rejuvenex,352,352,0
07:04:2014,reliftadvanced,http://click2hit.com/reliftadvanced,267,268,-1
07:04:2014,renique,http://click2hit.com/renique,654,663,-9
07:04:2014,restore,http://click2hit.com/restore,82,85,-3
07:04:2014,revitol,http://click2hit.com/revitol,62,62,0
07:04:2014,revivagenix,http://click2hit.com/revivagenix,227,227,0
07:04:2014,revivasol,http://click2hit.com/revivasol,2237,2238,-1
07:04:2014,revolyn,http://click2hit.com/revolyn,213,213,0
07:04:2014,revoreplex,http://click2hit.com/revoreplex,4,206,-202
07:04:2014,rippedmusclex,http://click2hit.com/rippedmusclex,12,12,0
07:04:2014,rvtl,http://click2hit.com/rvtl,1884,1894,-10
07:04:2014,saphireecig,http://click2hit.com/saphireecig,590,592,-2
07:04:2014,secretbodybulk,http://click2hit.com/secretbodybulk,306,306,0
07:04:2014,secretgarciniacambogia,http://click2hit.com/secretgarciniacambogia,249,249,0
07:04:2014,secretlift,http://click2hit.com/secretlift,6,10,-4
07:04:2014,sensa,http://click2hit.com/sensa,131,131,0
07:04:2014,simplycleanse,http://click2hit.com/simplycleanse,233,234,-1
07:04:2014,simplygarciniacambogia,http://click2hit.com/simplygarciniacambogia,429,431,-2
07:04:2014,simplygreencoffee,http://click2hit.com/simplygreencoffee,326,328,-2
07:04:2014,skinliftadvanced,http://click2hit.com/skinliftadvanced,221,221,0
07:04:2014,skinnyfiber,http://click2hit.com/skinnyfiber,397,397,0
07:04:2014,slendera-1,http://click2hit.com/slendera-1,39,39,0
07:04:2014,slendera-sab,http://click2hit.com/slendera-sab,68,68,0
07:04:2014,slimberrymax,http://click2hit.com/slimberrymax,255,256,-1
07:04:2014,slimbodycleanse,http://click2hit.com/slimbodycleanse,3095,3101,-6
07:04:2014,slimbodyketones,http://click2hit.com/slimbodyketones,110,120,-10
07:04:2014,slimcleanseplus,http://click2hit.com/slimcleanseplus,109,110,-1
07:04:2014,slimlean,http://click2hit.com/slimlean,1034,1034,0
07:04:2014,slimnogym,http://click2hit.com/slimnogym,222,222,0
07:04:2014,slimtrimpm,http://click2hit.com/slimtrimpm,31,38,-7
07:04:2014,smileprodirect,http://click2hit.com/smileprodirect,2894,2902,-8
07:04:2014,solpria,http://click2hit.com/solpria,1080,1080,0
07:04:2014,sparkwhitening,http://click2hit.com/sparkwhitening,1602,1603,-1
07:04:2014,strawberrygarciniacambogia,http://click2hit.com/strawberrygarciniacambogia,432,435,-3
07:04:2014,superbetaprostate,http://click2hit.com/superbetaprostate,152,152,0
07:04:2014,supercoloncleanse1800,http://click2hit.com/supercoloncleanse1800,288,289,-1
07:04:2014,supergarciniacambogia,http://click2hit.com/supergarciniacambogia,975,980,-5
07:04:2014,superiorvelvet,http://click2hit.com/superiorvelvet,456,465,-9
07:04:2014,superketoneplus,http://click2hit.com/superketoneplus,3992,4015,-23
07:04:2014,superlean,http://click2hit.com/superlean,200,200,0
07:04:2014,superleancoloncleanse,http://click2hit.com/superleancoloncleanse,1322,1331,-9
07:04:2014,supertestoboost,http://click2hit.com/supertestoboost,130,131,-1
07:04:2014,superyaconsyrup1000,http://click2hit.com/superyaconsyrup1000,23,23,0
07:04:2014,supracleanse350,http://click2hit.com/supracleanse350,588,612,-24
07:04:2014,supremeantler,http://click2hit.com/supremeantler,128,129,-1
07:04:2014,svelme,http://click2hit.com/svelme,46,46,0
07:04:2014,swolecreatinemuscle,http://click2hit.com/swolecreatinemuscle,186,186,0
07:04:2014,syneocell,http://click2hit.com/syneocell,188,188,0
07:04:2014,tadvance,http://click2hit.com/tadvance,468,469,-1
07:04:2014,testabolancyp,http://click2hit.com/testabolancyp,343,343,0
07:04:2014,testocoreadvanced,http://click2hit.com/testocoreadvanced,258,281,-23
07:04:2014,testoforceedge,http://click2hit.com/testoforceedge,477,477,0
07:04:2014,testoforcex,http://click2hit.com/testoforcex,293,293,0
07:04:2014,testolimit,http://click2hit.com/testolimit,38,38,0
07:04:2014,testomax,http://click2hit.com/testomax,274,274,0
07:04:2014,testoril,http://click2hit.com/testoril,522,522,0
07:04:2014,testorushrx,http://click2hit.com/testorushrx,393,400,-7
07:04:2014,testoupmax,http://click2hit.com/testoupmax,88,95,-7
07:04:2014,testrx360,http://click2hit.com/testrx360,333,333,0
07:04:2014,testtoforcextreme,http://click2hit.com/testtoforcextreme,386,386,0
07:04:2014,testx180,http://click2hit.com/testx180,1388,1400,-12
07:04:2014,thermoblackx,http://click2hit.com/thermoblackx,138,139,-1
07:04:2014,thermoextreme1,http://click2hit.com/thermoextreme1,569,570,-1
07:04:2014,thermofactorx,http://click2hit.com/thermofactorx,814,815,-1
07:04:2014,thermosculptpro,http://click2hit.com/thermosculptpro,319,322,-3
07:04:2014,titaniumprox,http://click2hit.com/titaniumprox,786,787,-1
07:04:2014,tlevelboost,http://click2hit.com/tlevelboost,63,63,0
07:04:2014,tonaderm,http://click2hit.com/tonaderm,199,200,-1
07:04:2014,totalcleansecomplete,http://click2hit.com/totalcleansecomplete,350,369,-19
07:04:2014,trigx2,http://click2hit.com/trigx2,329,330,-1
07:04:2014,trimextrin,http://click2hit.com/trimextrin,172,172,0
07:04:2014,truburnplus,http://click2hit.com/truburnplus,27,27,0
07:04:2014,truecleansecomplete,http://click2hit.com/truecleansecomplete,147,168,-21
07:04:2014,turbofrce,http://click2hit.com/turbofrce,419,419,0
07:04:2014,ultracelebdiet,http://click2hit.com/ultracelebdiet,358,359,-1
07:04:2014,ultracleansepure,http://click2hit.com/ultracleansepure,381,385,-4
07:04:2014,ultracoloncleanse,http://click2hit.com/ultracoloncleanse,44,44,0
07:04:2014,ultrafinesse,http://click2hit.com/ultrafinesse,83,84,-1
07:04:2014,ultragarciniacambogia,http://click2hit.com/ultragarciniacambogia,46,51,-5
07:04:2014,ultramaxtestosterone,http://click2hit.com/ultramaxtestosterone,226,227,-1
07:04:2014,ultraslim,http://click2hit.com/ultraslim,188,188,0
07:04:2014,umoris,http://click2hit.com/umoris,397,400,-3
07:04:2014,vantage,http://click2hit.com/vantage,4,5,-1
07:04:2014,vapexecig,http://click2hit.com/vapexecig,338,338,0
07:04:2014,vimaxdetox,http://click2hit.com/vimaxdetox,881,883,-2
07:04:2014,virilityex,http://click2hit.com/virilityex,202,202,0
07:04:2014,vitaberryburn,http://click2hit.com/vitaberryburn,371,371,0
07:04:2014,vitaberrytrim,http://click2hit.com/vitaberrytrim,1801,1804,-3
07:04:2014,vitacleanse,http://click2hit.com/vitacleanse,4448,4474,-26
07:04:2014,vitaketone,http://click2hit.com/vitaketone,929,936,-7
07:04:2014,vitalcleanse,http://click2hit.com/vitalcleanse,181,181,0
07:04:2014,vitalcleansecomplete,http://click2hit.com/vitalcleansecomplete,748,752,-4
07:04:2014,vitalifedetox,http://click2hit.com/vitalifedetox,736,742,-6
07:04:2014,vitalikortest,http://click2hit.com/vitalikortest,592,592,0
07:04:2014,vitalipo,http://click2hit.com/vitalipo,120,122,-2
07:04:2014,vitalitygreencoffee,http://click2hit.com/vitalitygreencoffee,197,197,0
07:04:2014,vitamaxgarciniacambogia,http://click2hit.com/vitamaxgarciniacambogia,1753,1759,-6
07:04:2014,vyalis,http://click2hit.com/vyalis,232,232,0
07:04:2014,wrinklerewind,http://click2hit.com/wrinklerewind,5655,5681,-26
07:04:2014,xmrecovery,http://click2hit.com/xmrecovery,142,144,-2
07:04:2014,xtremegarciniacambogia,http://click2hit.com/xtremegarciniacambogia,483,483,0
07:04:2014,xtremenitro,http://click2hit.com/xtremenitro,14,22,-8
07:04:2014,xtremetestosteronebooster,http://click2hit.com/xtremetestosteronebooster,363,363,0
07:04:2014,yaconmolasses,http://click2hit.com/yaconmolasses,80,80,0
07:04:2014,yaconrootmax,http://click2hit.com/yaconrootmax,1021,1095,-74
07:04:2014,yaconsyrupdirect,http://click2hit.com/yaconsyrupdirect,213,214,-1
07:04:2014,yolosleep,http://click2hit.com/yolosleep,213,213,0
07:04:2014,youthkitantiaging,http://click2hit.com/youthkitantiaging,196,197,-1
07:04:2014,zenacose,http://click2hit.com/zenacose,161,162,-1
07:04:2014,zenscleanse,http://click2hit.com/zenscleanse,2601,2602,-1
07:04:2014,zinncollection,http://click2hit.com/zinncollection,178,179,-1
07:04:2014,zolyria,http://click2hit.com/zolyria,480,486,-6
07:04:2014,zyloslim,http://click2hit.com/zyloslim,3742,3751,-9
07:04:2014,zymbiotix,http://click2hit.com/zymbiotix,1238,1253,-15
