dt_today,sitetitle,sitelink,pre_click,new_clicks,difrnce
04:04:2014,5stargarciniacambogia,http://click2hit.com/5stargarciniacambogia,82,84,-2
04:04:2014,Adrenalast,http://click2hit.com/Adrenalast,546,546,0
04:04:2014,Anataflex,http://click2hit.com/Anataflex,1280,1287,-7
04:04:2014,Diabetix,http://click2hit.com/Diabetix,724,724,0
04:04:2014,Equinox,http://click2hit.com/Equinox,8504,8527,-23
04:04:2014,LuxeCoat,http://click2hit.com/LuxeCoat,409,409,0
04:04:2014,NOX360,http://click2hit.com/NOX360,50,50,0
04:04:2014,Prescopodene,http://click2hit.com/Prescopodene,1347,1348,-1
04:04:2014,Puregarciniaslim,http://click2hit.com/Puregarciniaslim,168,342,-174
04:04:2014,RevoReplex,http://click2hit.com/RevoReplex,203,2,201
04:04:2014,absoluteraspberryketone,http://click2hit.com/absoluteraspberryketone,872,2,870
04:04:2014,acaiberrypuremax,http://click2hit.com/acaiberrypuremax,168,169,-1
04:04:2014,actionprowhite,http://click2hit.com/actionprowhite,2748,13,2735
04:04:2014,activedetoxcleanse,http://click2hit.com/activedetoxcleanse,16,16,0
04:04:2014,activeraspberryketone,http://click2hit.com/activeraspberryketone,693,23,670
04:04:2014,advancedgarciniacambogia,http://click2hit.com/advancedgarciniacambogia,778,778,0
04:04:2014,advancedpuregarcinia,http://click2hit.com/advancedpuregarcinia,551,552,-1
04:04:2014,advancedtest,http://click2hit.com/advancedtest,567,568,-1
04:04:2014,advancedtrimgreencoffee,http://click2hit.com/advancedtrimgreencoffee,1670,1672,-2
04:04:2014,africanmangopremier,http://click2hit.com/africanmangopremier,742,742,0
04:04:2014,agelesshealthsolution,http://click2hit.com/agelesshealthsolution,119,120,-1
04:04:2014,alleureantiagingcream,http://click2hit.com/alleureantiagingcream,56,87,-31
04:04:2014,alleureeyeserum,http://click2hit.com/alleureeyeserum,58,84,-26
04:04:2014,aloeferoxcleanse,http://click2hit.com/aloeferoxcleanse,1255,1276,-21
04:04:2014,aloeveracleanse,http://click2hit.com/aloeveracleanse,632,634,-2
04:04:2014,alore,http://click2hit.com/alore,3838,3858,-20
04:04:2014,alphacuthd,http://click2hit.com/alphacuthd,38,39,-1
04:04:2014,alphagenix,http://click2hit.com/alphagenix,4,19,-15
04:04:2014,alphamale,http://click2hit.com/alphamale,197,197,0
04:04:2014,alphamax1,http://click2hit.com/alphamax1,249,250,-1
04:04:2014,amacari,http://click2hit.com/amacari,151,152,-1
04:04:2014,amazingcleanse,http://click2hit.com/amazingcleanse,2,2,0
04:04:2014,ambitrimrx,http://click2hit.com/ambitrimrx,770,772,-2
04:04:2014,amino,http://click2hit.com/amino,1267,1269,-2
04:04:2014,andromale,http://click2hit.com/andromale,532,532,0
04:04:2014,anoradrol,http://click2hit.com/anoradrol,85,85,0
04:04:2014,aussiegarciniacambogia,http://click2hit.com/aussiegarciniacambogia,157,157,0
04:04:2014,authenticgarciniacambogia,http://click2hit.com/authenticgarciniacambogia,65,67,-2
04:04:2014,beaute,http://click2hit.com/beaute,645,645,0
04:04:2014,bellaathome,http://click2hit.com/bellaathome,1751,1755,-4
04:04:2014,bellapure,http://click2hit.com/bellapure,1659,1671,-12
04:04:2014,bellecomplex,http://click2hit.com/bellecomplex,635,638,-3
04:04:2014,berryherbalcleanse,http://click2hit.com/berryherbalcleanse,570,570,0
04:04:2014,berrythingarciniacambogia,http://click2hit.com/berrythingarciniacambogia,540,540,0
04:04:2014,betaalalinemax,http://click2hit.com/betaalalinemax,567,568,-1
04:04:2014,betaboost,http://click2hit.com/betaboost,106,107,-1
04:04:2014,betaforce,http://click2hit.com/betaforce,653,654,-1
04:04:2014,beyondraspberryketone,http://click2hit.com/beyondraspberryketone,2098,2098,0
04:04:2014,biocareslimplus,http://click2hit.com/biocareslimplus,312,312,0
04:04:2014,biocarexl,http://click2hit.com/biocarexl,325,326,-1
04:04:2014,biogeniste,http://click2hit.com/biogeniste,447,447,0
04:04:2014,blackbullmaleenhancement,http://click2hit.com/blackbullmaleenhancement,1450,1450,0
04:04:2014,blackdiamond,http://click2hit.com/blackdiamond,382,398,-16
04:04:2014,blacklineelite,http://click2hit.com/blacklineelite,1361,1388,-27
04:04:2014,blastxl,http://click2hit.com/blastxl,142,142,0
04:04:2014,blizzadwhite,http://click2hit.com/blizzadwhite,2402,9,2393
04:04:2014,bluemagicplus,http://click2hit.com/bluemagicplus,863,863,0
04:04:2014,bodyfuelxs,http://click2hit.com/bodyfuelxs,87,89,-2
04:04:2014,brandnew,http://click2hit.com/brandnew,350,350,0
04:04:2014,brandnewbooty,http://click2hit.com/brandnewbooty,766,766,0
04:04:2014,cafevertextraminceur,http://click2hit.com/cafevertextraminceur,1905,2008,-103
04:04:2014,carbuloss,http://click2hit.com/carbuloss,337,342,-5
04:04:2014,celebritybodynow,http://click2hit.com/celebritybodynow,418,418,0
04:04:2014,celebrityweightlosskit,http://click2hit.com/celebrityweightlosskit,359,359,0
04:04:2014,cellanafricanmango,http://click2hit.com/cellanafricanmango,1595,1735,-140
04:04:2014,cellogicaskin,http://click2hit.com/cellogicaskin,167,173,-6
04:04:2014,cenaless,http://click2hit.com/cenaless,75,75,0
04:04:2014,cenaslim,http://click2hit.com/cenaslim,380,385,-5
04:04:2014,cleandetox,http://click2hit.com/cleandetox,269,269,0
04:04:2014,cleansecatalystplus,http://click2hit.com/cleansecatalystplus,3275,3289,-14
04:04:2014,cleanseultimo,http://click2hit.com/cleanseultimo,1396,1400,-4
04:04:2014,cocogeniceyeserum,http://click2hit.com/cocogeniceyeserum,4,5,-1
04:04:2014,coffeecleansemax,http://click2hit.com/coffeecleansemax,379,381,-2
04:04:2014,coffeepurecleanse,http://click2hit.com/coffeepurecleanse,41,43,-2
04:04:2014,coleanse,http://click2hit.com/coleanse,2037,2049,-12
04:04:2014,collagen,http://click2hit.com/collagen,2,5,-3
04:04:2014,collagenfaceserum,http://click2hit.com/collagenfaceserum,41,45,-4
04:04:2014,colodetox,http://click2hit.com/colodetox,528,530,-2
04:04:2014,colodetoxplus,http://click2hit.com/colodetoxplus,91,92,-1
04:04:2014,coloncleanse1300,http://click2hit.com/coloncleanse1300,280,280,0
04:04:2014,coloncleansecomplete,http://click2hit.com/coloncleansecomplete,1277,1279,-2
04:04:2014,coloncleansetotal,http://click2hit.com/coloncleansetotal,765,765,0
04:04:2014,colondetoxpro,http://click2hit.com/colondetoxpro,13,23,-10
04:04:2014,colonpurecleanse,http://click2hit.com/colonpurecleanse,404,408,-4
04:04:2014,colothin,http://click2hit.com/colothin,189,189,0
04:04:2014,columbiangreencoffeebean,http://click2hit.com/columbiangreencoffeebean,717,721,-4
04:04:2014,combogiaplus,http://click2hit.com/combogiaplus,328,329,-1
04:04:2014,completecoffeecleanse,http://click2hit.com/completecoffeecleanse,394,394,0
04:04:2014,complexiderm,http://click2hit.com/complexiderm,186,187,-1
04:04:2014,cosimarevival,http://click2hit.com/cosimarevival,182,182,0
04:04:2014,cosmitone,http://click2hit.com/cosmitone,1329,1330,-1
04:04:2014,csorex,http://click2hit.com/csorex,105,106,-1
04:04:2014,curcovia,http://click2hit.com/curcovia,424,424,0
04:04:2014,cutiecurves,http://click2hit.com/cutiecurves,246,246,0
04:04:2014,cytotrim,http://click2hit.com/cytotrim,1871,0,1871
04:04:2014,dailyeyerestoration,http://click2hit.com/dailyeyerestoration,134,135,-1
04:04:2014,dellure,http://click2hit.com/dellure,114,114,0
04:04:2014,dellurecollagen,http://click2hit.com/dellurecollagen,568,568,0
04:04:2014,dermafirm,http://click2hit.com/dermafirm,757,758,-1
04:04:2014,dermajuvenate,http://click2hit.com/dermajuvenate,2279,2291,-12
04:04:2014,dermalift,http://click2hit.com/dermalift,235,235,0
04:04:2014,dermallo,http://click2hit.com/dermallo,268,268,0
04:04:2014,dermalmeds,http://click2hit.com/dermalmeds,441,444,-3
04:04:2014,dermangelie,http://click2hit.com/dermangelie,150,151,-1
04:04:2014,derminelift,http://click2hit.com/derminelift,402,402,0
04:04:2014,dermology,http://click2hit.com/dermology,40,40,0
04:04:2014,detoxmax,http://click2hit.com/detoxmax,48,50,-2
04:04:2014,dietultimo,http://click2hit.com/dietultimo,2478,2487,-9
04:04:2014,digestItcoloncleanse,http://click2hit.com/digestItcoloncleanse,59,59,0
04:04:2014,duplicellp199,http://click2hit.com/duplicellp199,30,32,-2
04:04:2014,duplicellp199facetherapy,http://click2hit.com/duplicellp199facetherapy,29,30,-1
04:04:2014,ecoflex,http://click2hit.com/ecoflex,123,124,-1
04:04:2014,electravx,http://click2hit.com/electravx,178,178,0
04:04:2014,elevategf,http://click2hit.com/elevategf,263,265,-2
04:04:2014,elite360,http://click2hit.com/elite360,67,67,0
04:04:2014,elliskin,http://click2hit.com/elliskin,496,498,-2
04:04:2014,endorev,http://click2hit.com/endorev,459,459,0
04:04:2014,ephedrix,http://click2hit.com/ephedrix,226,226,0
04:04:2014,equivita,http://click2hit.com/equivita,7628,7671,-43
04:04:2014,essentialdetox,http://click2hit.com/essentialdetox,423,426,-3
04:04:2014,extagen,http://click2hit.com/extagen,313,314,-1
04:04:2014,extremefx,http://click2hit.com/extremefx,339,339,0
04:04:2014,eyeluminous,http://click2hit.com/eyeluminous,542,558,-16
04:04:2014,fembalance,http://click2hit.com/fembalance,360,360,0
04:04:2014,firmativ,http://click2hit.com/firmativ,716,729,-13
04:04:2014,flawlessbeauty,http://click2hit.com/flawlessbeauty,76,94,-18
04:04:2014,flexwell,http://click2hit.com/flexwell,101,102,-1
04:04:2014,forceeffect,http://click2hit.com/forceeffect,56,92,-36
04:04:2014,formularezvmagic,http://click2hit.com/formularezvmagic,231,231,0
04:04:2014,fortdietmax,http://click2hit.com/fortdietmax,79,79,0
04:04:2014,fortmaxdiet,http://click2hit.com/fortmaxdiet,70,72,-2
04:04:2014,garciniaberrythin,http://click2hit.com/garciniaberrythin,477,477,0
04:04:2014,garciniacambogia1300,http://click2hit.com/garciniacambogia1300,650,653,-3
04:04:2014,garciniacambogia360,http://click2hit.com/garciniacambogia360,10,11,-1
04:04:2014,garciniacambogia500,http://click2hit.com/garciniacambogia500,2,2,0
04:04:2014,garciniacambogiablast,http://click2hit.com/garciniacambogiablast,698,716,-18
04:04:2014,garciniacambogiaburn,http://click2hit.com/garciniacambogiaburn,92,92,0
04:04:2014,garciniacambogiacomplex,http://click2hit.com/garciniacambogiacomplex,326,326,0
04:04:2014,garciniacambogiaextract,http://click2hit.com/garciniacambogiaextract,47,47,0
04:04:2014,garciniacambogiafit1300,http://click2hit.com/garciniacambogiafit1300,118,124,-6
04:04:2014,garciniacambogiaformula,http://click2hit.com/garciniacambogiaformula,26,27,-1
04:04:2014,garciniacambogiahca,http://click2hit.com/garciniacambogiahca,227,1,226
04:04:2014,garciniacambogiaplus,http://click2hit.com/garciniacambogiaplus,1131,1133,-2
04:04:2014,garciniacambogiapro,http://click2hit.com/garciniacambogiapro,13,16,-3
04:04:2014,garciniacambogiaselect,http://click2hit.com/garciniacambogiaselect,485,485,0
04:04:2014,garciniacambogiaslimfast,http://click2hit.com/garciniacambogiaslimfast,1777,1780,-3
04:04:2014,garciniacambogiaslimsystem,http://click2hit.com/garciniacambogiaslimsystem,1088,1091,-3
04:04:2014,garciniacambogiaxt,http://click2hit.com/garciniacambogiaxt,126,137,-11
04:04:2014,garciniacambogiaz,http://click2hit.com/garciniacambogiaz,68,0,68
04:04:2014,garciniacombogiasupreme,http://click2hit.com/garciniacombogiasupreme,22,22,0
04:04:2014,garciniadietmax,http://click2hit.com/garciniadietmax,306,309,-3
04:04:2014,garciniaextractplus,http://click2hit.com/garciniaextractplus,230,231,-1
04:04:2014,garciniaforte,http://click2hit.com/garciniaforte,167,1,166
04:04:2014,garciniahca,http://click2hit.com/garciniahca,139,139,0
04:04:2014,garciniahcapremium,http://click2hit.com/garciniahcapremium,92,94,-2
04:04:2014,garciniaplus,http://click2hit.com/garciniaplus,1952,1957,-5
04:04:2014,garciniasuperdiet,http://click2hit.com/garciniasuperdiet,171,171,0
04:04:2014,garciniawonder,http://click2hit.com/garciniawonder,769,792,-23
04:04:2014,garciniawow,http://click2hit.com/garciniawow,65,72,-7
04:04:2014,garciniaxslim,http://click2hit.com/garciniaxslim,427,454,-27
04:04:2014,gc180xt,http://click2hit.com/gc180xt,535,541,-6
04:04:2014,gcbmaxgreencoffee,http://click2hit.com/gcbmaxgreencoffee,341,341,0
04:04:2014,gcfitsgarcinia,http://click2hit.com/gcfitsgarcinia,4,5,-1
04:04:2014,gcxsdiet,http://click2hit.com/gcxsdiet,29,36,-7
04:04:2014,genesis,http://click2hit.com/genesis,38,41,-3
04:04:2014,gogiberryburn,http://click2hit.com/gogiberryburn,240,7,233
04:04:2014,gojiactives,http://click2hit.com/gojiactives,1450,1459,-9
04:04:2014,gojiadvance,http://click2hit.com/gojiadvance,379,381,-2
04:04:2014,gojimax,http://click2hit.com/gojimax,232,233,-1
04:04:2014,gojislim,http://click2hit.com/gojislim,20092,20132,-40
04:04:2014,govapor,http://click2hit.com/govapor,54,61,-7
04:04:2014,greencoffeebeanthin,http://click2hit.com/greencoffeebeanthin,278,281,-3
04:04:2014,greencoffeebody,http://click2hit.com/greencoffeebody,414,414,0
04:04:2014,greencoffeecleanse,http://click2hit.com/greencoffeecleanse,16,17,-1
04:04:2014,greencoffeecleanse1,http://click2hit.com/greencoffeecleanse1,24,24,0
04:04:2014,greencoffeecleanses,http://click2hit.com/greencoffeecleanses,671,711,-40
04:04:2014,greencoffeeextraslim,http://click2hit.com/greencoffeeextraslim,269,270,-1
04:04:2014,greencoffeefatburn,http://click2hit.com/greencoffeefatburn,1557,1560,-3
04:04:2014,greencoffeenaxx,http://click2hit.com/greencoffeenaxx,194,194,0
04:04:2014,greencoffeeplus,http://click2hit.com/greencoffeeplus,100,100,0
04:04:2014,greencoffeeprogram,http://click2hit.com/greencoffeeprogram,53,53,0
04:04:2014,greencoffeerevolution,http://click2hit.com/greencoffeerevolution,16,20,-4
04:04:2014,greencoffeespeedslim,http://click2hit.com/greencoffeespeedslim,1237,1271,-34
04:04:2014,greencoffeesupreme,http://click2hit.com/greencoffeesupreme,344,345,-1
04:04:2014,greencoffeesupremecleanse,http://click2hit.com/greencoffeesupremecleanse,114,115,-1
04:04:2014,greendetoxpatch,http://click2hit.com/greendetoxpatch,282,282,0
04:04:2014,greenleancoffeebean,http://click2hit.com/greenleancoffeebean,204,204,0
04:04:2014,greentonepromuscle,http://click2hit.com/greentonepromuscle,212,212,0
04:04:2014,growxl,http://click2hit.com/growxl,2685,2692,-7
04:04:2014,hairgenesis,http://click2hit.com/hairgenesis,77,78,-1
04:04:2014,hardknight,http://click2hit.com/hardknight,1415,1417,-2
04:04:2014,hardknight-1,http://click2hit.com/hardknight-1,79,79,0
04:04:2014,hawaiislim,http://click2hit.com/hawaiislim,133,136,-3
04:04:2014,healthycleanse,http://click2hit.com/healthycleanse,509,510,-1
04:04:2014,heboost,http://click2hit.com/heboost,233,233,0
04:04:2014,hghfuel,http://click2hit.com/hghfuel,20,20,0
04:04:2014,hghpro,http://click2hit.com/hghpro,3913,7,3906
04:04:2014,hghxl,http://click2hit.com/hghxl,130,134,-4
04:04:2014,hight,http://click2hit.com/hight,322,322,0
04:04:2014,hspactives,http://click2hit.com/hspactives,2132,2141,-9
04:04:2014,htrush,http://click2hit.com/htrush,291,292,-1
04:04:2014,hydradiance,http://click2hit.com/hydradiance,495,502,-7
04:04:2014,hydrafirm,http://click2hit.com/hydrafirm,252,252,0
04:04:2014,hydravella,http://click2hit.com/hydravella,223,223,0
04:04:2014,hydroface,http://click2hit.com/hydroface,615,616,-1
04:04:2014,hydroxatone90,http://click2hit.com/hydroxatone90,320,321,-1
04:04:2014,hydroxatonebbcream,http://click2hit.com/hydroxatonebbcream,72,72,0
04:04:2014,idolize,http://click2hit.com/idolize,79,85,-6
04:04:2014,instaleanketones,http://click2hit.com/instaleanketones,694,695,-1
04:04:2014,instantderma,http://click2hit.com/instantderma,183,183,0
04:04:2014,instantlift,http://click2hit.com/instantlift,471,471,0
04:04:2014,juvalife,http://click2hit.com/juvalife,85,86,-1
04:04:2014,juvamend,http://click2hit.com/juvamend,179,181,-2
04:04:2014,juvesiio,http://click2hit.com/juvesiio,56,56,0
04:04:2014,ketoneadvanced,http://click2hit.com/ketoneadvanced,53,62,-9
04:04:2014,ketonepremium,http://click2hit.com/ketonepremium,528,528,0
04:04:2014,kollagen,http://click2hit.com/kollagen,76,76,0
04:04:2014,l-carnitineplus,http://click2hit.com/l-carnitineplus,144,144,0
04:04:2014,ladermanique,http://click2hit.com/ladermanique,1714,1715,-1
04:04:2014,larginineplus,http://click2hit.com/larginineplus,30,30,0
04:04:2014,leanmusclex,http://click2hit.com/leanmusclex,4,4,0
04:04:2014,leptizin,http://click2hit.com/leptizin,101,101,0
04:04:2014,lifecell,http://click2hit.com/lifecell,140,140,0
04:04:2014,liftandglowpro,http://click2hit.com/liftandglowpro,35,36,-1
04:04:2014,liftderma,http://click2hit.com/liftderma,741,754,-13
04:04:2014,liftserumpro,http://click2hit.com/liftserumpro,53,53,0
04:04:2014,liftvapor,http://click2hit.com/liftvapor,893,894,-1
04:04:2014,lipo13,http://click2hit.com/lipo13,709,786,-77
04:04:2014,lipog3,http://click2hit.com/lipog3,231,271,-40
04:04:2014,liposlim,http://click2hit.com/liposlim,209,209,0
04:04:2014,lisocleanse,http://click2hit.com/lisocleanse,47,57,-10
04:04:2014,lorelia,http://click2hit.com/lorelia,2037,2052,-15
04:04:2014,lumeraeyeserum,http://click2hit.com/lumeraeyeserum,2191,2202,-11
04:04:2014,luminant,http://click2hit.com/luminant,396,396,0
04:04:2014,luminantskin,http://click2hit.com/luminantskin,411,411,0
04:04:2014,luminique,http://click2hit.com/luminique,81,83,-2
04:04:2014,luministeyegel,http://click2hit.com/luministeyegel,209,209,0
04:04:2014,lunarsleep,http://click2hit.com/lunarsleep,222,235,-13
04:04:2014,lunathin,http://click2hit.com/lunathin,140,141,-1
04:04:2014,lxwpro-t,http://click2hit.com/lxwpro-t,8,14,-6
04:04:2014,lysocleanse,http://click2hit.com/lysocleanse,734,737,-3
04:04:2014,massivevitality,http://click2hit.com/massivevitality,26,27,-1
04:04:2014,masspmnight,http://click2hit.com/masspmnight,35,36,-1
04:04:2014,maxburncambogia,http://click2hit.com/maxburncambogia,6872,6876,-4
04:04:2014,maxcleanse,http://click2hit.com/maxcleanse,269,272,-3
04:04:2014,maxdetox,http://click2hit.com/maxdetox,374,375,-1
04:04:2014,maxgarciniaburn,http://click2hit.com/maxgarciniaburn,249,251,-2
04:04:2014,maxleanx,http://click2hit.com/maxleanx,279,279,0
04:04:2014,maxlight,http://click2hit.com/maxlight,237,5,232
04:04:2014,maxmuscleblast,http://click2hit.com/maxmuscleblast,34,34,0
04:04:2014,maxmusclelean,http://click2hit.com/maxmusclelean,46,47,-1
04:04:2014,maxtrimraspberryketone,http://click2hit.com/maxtrimraspberryketone,105,106,-1
04:04:2014,maxxmale,http://click2hit.com/maxxmale,182,183,-1
04:04:2014,maxxtest300,http://click2hit.com/maxxtest300,17,19,-2
04:04:2014,miraclegarciniacambogia1300,http://click2hit.com/miraclegarciniacambogia1300,46,49,-3
04:04:2014,miraclegarciniacambogiarx,http://click2hit.com/miraclegarciniacambogiarx,52,53,-1
04:04:2014,miraclephytoceramides,http://click2hit.com/miraclephytoceramides,2074,2107,-33
04:04:2014,miracleraspberryketone,http://click2hit.com/miracleraspberryketone,21,23,-2
04:04:2014,mitoslim,http://click2hit.com/mitoslim,749,749,0
04:04:2014,mizulean,http://click2hit.com/mizulean,245,245,0
04:04:2014,musclecorex,http://click2hit.com/musclecorex,514,514,0
04:04:2014,muscleforcex,http://click2hit.com/muscleforcex,88,88,0
04:04:2014,musclekingpro,http://click2hit.com/musclekingpro,301,301,0
04:04:2014,musclemax,http://click2hit.com/musclemax,218,226,-8
04:04:2014,muscleripx,http://click2hit.com/muscleripx,195,197,-2
04:04:2014,musclexedge,http://click2hit.com/musclexedge,524,525,-1
04:04:2014,musclexpro,http://click2hit.com/musclexpro,93,93,0
04:04:2014,musclezx90,http://click2hit.com/musclezx90,2899,2901,-2
04:04:2014,naturalburn,http://click2hit.com/naturalburn,258,258,0
04:04:2014,naturalcleanse,http://click2hit.com/naturalcleanse,812,812,0
04:04:2014,naturalcoloncleanseelite,http://click2hit.com/naturalcoloncleanseelite,312,314,-2
04:04:2014,naturaldiet,http://click2hit.com/naturaldiet,145,145,0
04:04:2014,naturalgarciniacambogiaburn,http://click2hit.com/naturalgarciniacambogiaburn,231,231,0
04:04:2014,naturalgreencleanse,http://click2hit.com/naturalgreencleanse,539,542,-3
04:04:2014,naturalgreencoffeeburn,http://click2hit.com/naturalgreencoffeeburn,423,423,0
04:04:2014,naturalpluscleanse,http://click2hit.com/naturalpluscleanse,124,125,-1
04:04:2014,naturalpurecleanse,http://click2hit.com/naturalpurecleanse,393,393,0
04:04:2014,neucleanseultimate,http://click2hit.com/neucleanseultimate,418,421,-3
04:04:2014,neugarciniacambogia,http://click2hit.com/neugarciniacambogia,12,12,0
04:04:2014,neuropathysupportformula,http://click2hit.com/neuropathysupportformula,238,241,-3
04:04:2014,newagecleanse,http://click2hit.com/newagecleanse,321,325,-4
04:04:2014,newlifecleanse,http://click2hit.com/newlifecleanse,154,154,0
04:04:2014,nidora,http://click2hit.com/nidora,453,480,-27
04:04:2014,nitricmaxmuscle,http://click2hit.com/nitricmaxmuscle,316,317,-1
04:04:2014,nitricmaxmuscle1,http://click2hit.com/nitricmaxmuscle1,60,60,0
04:04:2014,nitricpower,http://click2hit.com/nitricpower,416,2,414
04:04:2014,nitroxin,http://click2hit.com/nitroxin,27,29,-2
04:04:2014,nitroxl,http://click2hit.com/nitroxl,282,282,0
04:04:2014,nitroxpro,http://click2hit.com/nitroxpro,6139,6254,-115
04:04:2014,no2explodeextreme,http://click2hit.com/no2explodeextreme,1479,1480,-1
04:04:2014,no2factor,http://click2hit.com/no2factor,330,330,0
04:04:2014,no2maximus,http://click2hit.com/no2maximus,2306,2327,-21
04:04:2014,no2surge,http://click2hit.com/no2surge,160,189,-29
04:04:2014,nuetrim,http://click2hit.com/nuetrim,427,428,-1
04:04:2014,nutraburn10,http://click2hit.com/nutraburn10,95,95,0
04:04:2014,nutranaturalgarciniacambogia,http://click2hit.com/nutranaturalgarciniacambogia,114,114,0
04:04:2014,nutridiet,http://click2hit.com/nutridiet,951,968,-17
04:04:2014,nuvagenic,http://click2hit.com/nuvagenic,196,196,0
04:04:2014,nuvie,http://click2hit.com/nuvie,149,151,-2
04:04:2014,nuvocleanse,http://click2hit.com/nuvocleanse,591,591,0
04:04:2014,nuvoslim,http://click2hit.com/nuvoslim,309,337,-28
04:04:2014,onemoment,http://click2hit.com/onemoment,82,88,-6
04:04:2014,optimalstack,http://click2hit.com/optimalstack,458,458,0
04:04:2014,organiccleanse,http://click2hit.com/organiccleanse,2,2,0
04:04:2014,organiccleansedetox,http://click2hit.com/organiccleansedetox,50,51,-1
04:04:2014,organicgarciniacambogia,http://click2hit.com/organicgarciniacambogia,194,194,0
04:04:2014,originalgarciniacambogia,http://click2hit.com/originalgarciniacambogia,47,47,0
04:04:2014,originalyaconextract,http://click2hit.com/originalyaconextract,150,151,-1
04:04:2014,originalyaconsyrup,http://click2hit.com/originalyaconsyrup,54,55,-1
04:04:2014,orvigomax,http://click2hit.com/orvigomax,26,36,-10
04:04:2014,ourgreencleanse,http://click2hit.com/ourgreencleanse,142,144,-2
04:04:2014,oxygenius,http://click2hit.com/oxygenius,1305,1319,-14
04:04:2014,pelevoni,http://click2hit.com/pelevoni,317,318,-1
04:04:2014,platinumgarciniacambogia,http://click2hit.com/platinumgarciniacambogia,353,355,-2
04:04:2014,poshcream,http://click2hit.com/poshcream,24,24,0
04:04:2014,powermax,http://click2hit.com/powermax,153,3,150
04:04:2014,powerprecision,http://click2hit.com/powerprecision,107,113,-6
04:04:2014,poweruphealthgarcinia,http://click2hit.com/poweruphealthgarcinia,60,90,-30
04:04:2014,premiermangocleanse,http://click2hit.com/premiermangocleanse,202,204,-2
04:04:2014,premiumgarciniacambogiaslim,http://click2hit.com/premiumgarciniacambogiaslim,570,42,528
04:04:2014,premiumgreencoffeebean,http://click2hit.com/premiumgreencoffeebean,206,207,-1
04:04:2014,procollagen,http://click2hit.com/procollagen,265,266,-1
04:04:2014,procoloncleanse,http://click2hit.com/procoloncleanse,167,167,0
04:04:2014,prodermagenix,http://click2hit.com/prodermagenix,183,185,-2
04:04:2014,prodermagenixplus,http://click2hit.com/prodermagenixplus,255,256,-1
04:04:2014,progain350,http://click2hit.com/progain350,3,3,0
04:04:2014,prolong,http://click2hit.com/prolong,495,520,-25
04:04:2014,prolongz,http://click2hit.com/prolongz,415,420,-5
04:04:2014,promusclecomplex,http://click2hit.com/promusclecomplex,534,534,0
04:04:2014,pronutragarcinia,http://click2hit.com/pronutragarcinia,51,51,0
04:04:2014,protrim,http://click2hit.com/protrim,1044,1045,-1
04:04:2014,purafit,http://click2hit.com/purafit,364,364,0
04:04:2014,puragreencoffee,http://click2hit.com/puragreencoffee,286,286,0
04:04:2014,pureberrymax,http://click2hit.com/pureberrymax,266,267,-1
04:04:2014,purebiodiet,http://click2hit.com/purebiodiet,638,639,-1
04:04:2014,purecambogiaultra,http://click2hit.com/purecambogiaultra,163,178,-15
04:04:2014,purecambogiaultra-1,http://click2hit.com/purecambogiaultra-1,571,572,-1
04:04:2014,purecambogiaultra2,http://click2hit.com/purecambogiaultra2,172,172,0
04:04:2014,purecleanse,http://click2hit.com/purecleanse,497,499,-2
04:04:2014,purecleansemax,http://click2hit.com/purecleansemax,231,231,0
04:04:2014,purecolocleanse,http://click2hit.com/purecolocleanse,263,264,-1
04:04:2014,purecoloncleanser,http://click2hit.com/purecoloncleanser,1538,1539,-1
04:04:2014,puregarciniacambogia,http://click2hit.com/puregarciniacambogia,195,195,0
04:04:2014,puregarciniacambogia-1,http://click2hit.com/puregarciniacambogia-1,7339,7451,-112
04:04:2014,puregarciniacambogiaburn,http://click2hit.com/puregarciniacambogiaburn,2322,2323,-1
04:04:2014,puregarciniacambogiaplus,http://click2hit.com/puregarciniacambogiaplus,371,372,-1
04:04:2014,puregarciniacambogiapremium,http://click2hit.com/puregarciniacambogiapremium,1205,1211,-6
04:04:2014,puregarciniacambogiaslim,http://click2hit.com/puregarciniacambogiaslim,890,890,0
04:04:2014,puregarciniacambogiaslimsystem,http://click2hit.com/puregarciniacambogiaslimsystem,250,252,-2
04:04:2014,puregarciniacanada,http://click2hit.com/puregarciniacanada,54,54,0
04:04:2014,puregarciniaelite,http://click2hit.com/puregarciniaelite,31,31,0
04:04:2014,puregarciniaslim,http://click2hit.com/puregarciniaslim,342,168,174
04:04:2014,puregarciniaultra,http://click2hit.com/puregarciniaultra,512,513,-1
04:04:2014,puregarciniaultra-1,http://click2hit.com/puregarciniaultra-1,134,134,0
04:04:2014,puregreencoffee,http://click2hit.com/puregreencoffee,419,419,0
04:04:2014,puregreencoffeebeanplus,http://click2hit.com/puregreencoffeebeanplus,1761,1767,-6
04:04:2014,purelifecleanse1,http://click2hit.com/purelifecleanse1,90,178,-88
04:04:2014,purenitrate,http://click2hit.com/purenitrate,53,53,0
04:04:2014,purenitromax,http://click2hit.com/purenitromax,483,487,-4
04:04:2014,purensa,http://click2hit.com/purensa,1632,1638,-6
04:04:2014,pureraspberryketonepremium,http://click2hit.com/pureraspberryketonepremium,226,229,-3
04:04:2014,puressance,http://click2hit.com/puressance,124,124,0
04:04:2014,purestgarciniacambogia,http://click2hit.com/purestgarciniacambogia,19,19,0
04:04:2014,pureyaconsyrupextract,http://click2hit.com/pureyaconsyrupextract,253,254,-1
04:04:2014,pureyaconsyrupplus,http://click2hit.com/pureyaconsyrupplus,140,141,-1
04:04:2014,pureyaconxt,http://click2hit.com/pureyaconxt,69,72,-3
04:04:2014,px800greencoffee,http://click2hit.com/px800greencoffee,55,55,0
04:04:2014,quickgreencoffee,http://click2hit.com/quickgreencoffee,390,392,-2
04:04:2014,raspberryketonefresh,http://click2hit.com/raspberryketonefresh,1049,1053,-4
04:04:2014,raspberryketoneproslim,http://click2hit.com/raspberryketoneproslim,291,297,-6
04:04:2014,raspberryketones,http://click2hit.com/raspberryketones,302,308,-6
04:04:2014,raspberryslimplus,http://click2hit.com/raspberryslimplus,178,178,0
04:04:2014,raspberrytones,http://click2hit.com/raspberrytones,357,357,0
04:04:2014,raspberrytrim,http://click2hit.com/raspberrytrim,144,148,-4
04:04:2014,raspberryultraketone,http://click2hit.com/raspberryultraketone,194,194,0
04:04:2014,rawburn,http://click2hit.com/rawburn,144,144,0
04:04:2014,regularx,http://click2hit.com/regularx,61,76,-15
04:04:2014,rejouvance,http://click2hit.com/rejouvance,477,478,-1
04:04:2014,rejuvaglow,http://click2hit.com/rejuvaglow,65,65,0
04:04:2014,rejuvalash,http://click2hit.com/rejuvalash,247,253,-6
04:04:2014,rejuvalskin,http://click2hit.com/rejuvalskin,1283,6,1277
04:04:2014,rejuvenex,http://click2hit.com/rejuvenex,351,351,0
04:04:2014,reliftadvanced,http://click2hit.com/reliftadvanced,264,265,-1
04:04:2014,renique,http://click2hit.com/renique,623,635,-12
04:04:2014,restore,http://click2hit.com/restore,81,82,-1
04:04:2014,revitol,http://click2hit.com/revitol,60,61,-1
04:04:2014,revivagenix,http://click2hit.com/revivagenix,227,227,0
04:04:2014,revivasol,http://click2hit.com/revivasol,2217,2225,-8
04:04:2014,revolyn,http://click2hit.com/revolyn,213,213,0
04:04:2014,revoreplex,http://click2hit.com/revoreplex,2,206,-204
04:04:2014,rippedmusclex,http://click2hit.com/rippedmusclex,12,12,0
04:04:2014,rvtl,http://click2hit.com/rvtl,1862,1870,-8
04:04:2014,saphireecig,http://click2hit.com/saphireecig,588,588,0
04:04:2014,secretbodybulk,http://click2hit.com/secretbodybulk,303,305,-2
04:04:2014,secretgarciniacambogia,http://click2hit.com/secretgarciniacambogia,249,249,0
04:04:2014,secretlift,http://click2hit.com/secretlift,264,3,261
04:04:2014,sensa,http://click2hit.com/sensa,130,131,-1
04:04:2014,simplycleanse,http://click2hit.com/simplycleanse,232,232,0
04:04:2014,simplygarciniacambogia,http://click2hit.com/simplygarciniacambogia,424,427,-3
04:04:2014,simplygreencoffee,http://click2hit.com/simplygreencoffee,321,323,-2
04:04:2014,skinliftadvanced,http://click2hit.com/skinliftadvanced,219,219,0
04:04:2014,skinnyfiber,http://click2hit.com/skinnyfiber,396,397,-1
04:04:2014,slendera-1,http://click2hit.com/slendera-1,39,39,0
04:04:2014,slendera-sab,http://click2hit.com/slendera-sab,66,67,-1
04:04:2014,slimberrymax,http://click2hit.com/slimberrymax,251,252,-1
04:04:2014,slimbodycleanse,http://click2hit.com/slimbodycleanse,3078,3084,-6
04:04:2014,slimbodyketones,http://click2hit.com/slimbodyketones,86,94,-8
04:04:2014,slimcleanseplus,http://click2hit.com/slimcleanseplus,108,108,0
04:04:2014,slimlean,http://click2hit.com/slimlean,1030,1032,-2
04:04:2014,slimnogym,http://click2hit.com/slimnogym,222,222,0
04:04:2014,slimtrimpm,http://click2hit.com/slimtrimpm,367,5,362
04:04:2014,smileprodirect,http://click2hit.com/smileprodirect,2843,2868,-25
04:04:2014,solpria,http://click2hit.com/solpria,1077,1077,0
04:04:2014,sparkwhitening,http://click2hit.com/sparkwhitening,1602,1602,0
04:04:2014,strawberrygarciniacambogia,http://click2hit.com/strawberrygarciniacambogia,415,422,-7
04:04:2014,superbetaprostate,http://click2hit.com/superbetaprostate,151,152,-1
04:04:2014,supercoloncleanse1800,http://click2hit.com/supercoloncleanse1800,288,288,0
04:04:2014,supergarciniacambogia,http://click2hit.com/supergarciniacambogia,946,949,-3
04:04:2014,superiorvelvet,http://click2hit.com/superiorvelvet,418,438,-20
04:04:2014,superketoneplus,http://click2hit.com/superketoneplus,3887,3947,-60
04:04:2014,superlean,http://click2hit.com/superlean,200,200,0
04:04:2014,superleancoloncleanse,http://click2hit.com/superleancoloncleanse,1306,1312,-6
04:04:2014,supertestoboost,http://click2hit.com/supertestoboost,128,128,0
04:04:2014,superyaconsyrup1000,http://click2hit.com/superyaconsyrup1000,22,22,0
04:04:2014,supracleanse350,http://click2hit.com/supracleanse350,522,550,-28
04:04:2014,supremeantler,http://click2hit.com/supremeantler,126,126,0
04:04:2014,svelme,http://click2hit.com/svelme,45,46,-1
04:04:2014,swolecreatinemuscle,http://click2hit.com/swolecreatinemuscle,186,186,0
04:04:2014,syneocell,http://click2hit.com/syneocell,188,188,0
04:04:2014,tadvance,http://click2hit.com/tadvance,468,468,0
04:04:2014,testabolancyp,http://click2hit.com/testabolancyp,342,343,-1
04:04:2014,testocoreadvanced,http://click2hit.com/testocoreadvanced,246,251,-5
04:04:2014,testoforceedge,http://click2hit.com/testoforceedge,474,475,-1
04:04:2014,testoforcex,http://click2hit.com/testoforcex,293,293,0
04:04:2014,testolimit,http://click2hit.com/testolimit,34,34,0
04:04:2014,testomax,http://click2hit.com/testomax,274,274,0
04:04:2014,testoril,http://click2hit.com/testoril,520,520,0
04:04:2014,testorushrx,http://click2hit.com/testorushrx,348,367,-19
04:04:2014,testoupmax,http://click2hit.com/testoupmax,65,66,-1
04:04:2014,testrx360,http://click2hit.com/testrx360,331,331,0
04:04:2014,testtoforcextreme,http://click2hit.com/testtoforcextreme,383,383,0
04:04:2014,testx180,http://click2hit.com/testx180,1365,1376,-11
04:04:2014,thermoblackx,http://click2hit.com/thermoblackx,138,138,0
04:04:2014,thermoextreme1,http://click2hit.com/thermoextreme1,568,568,0
04:04:2014,thermofactorx,http://click2hit.com/thermofactorx,807,812,-5
04:04:2014,thermosculptpro,http://click2hit.com/thermosculptpro,317,317,0
04:04:2014,titaniumprox,http://click2hit.com/titaniumprox,783,783,0
04:04:2014,tlevelboost,http://click2hit.com/tlevelboost,62,62,0
04:04:2014,tonaderm,http://click2hit.com/tonaderm,191,195,-4
04:04:2014,totalcleansecomplete,http://click2hit.com/totalcleansecomplete,321,331,-10
04:04:2014,trigx2,http://click2hit.com/trigx2,328,328,0
04:04:2014,trimextrin,http://click2hit.com/trimextrin,171,171,0
04:04:2014,truburnplus,http://click2hit.com/truburnplus,25,26,-1
04:04:2014,truecleansecomplete,http://click2hit.com/truecleansecomplete,116,123,-7
04:04:2014,turbofrce,http://click2hit.com/turbofrce,415,416,-1
04:04:2014,ultracelebdiet,http://click2hit.com/ultracelebdiet,354,355,-1
04:04:2014,ultracleansepure,http://click2hit.com/ultracleansepure,326,351,-25
04:04:2014,ultracoloncleanse,http://click2hit.com/ultracoloncleanse,39,40,-1
04:04:2014,ultrafinesse,http://click2hit.com/ultrafinesse,71,75,-4
04:04:2014,ultragarciniacambogia,http://click2hit.com/ultragarciniacambogia,46,46,0
04:04:2014,ultramaxtestosterone,http://click2hit.com/ultramaxtestosterone,226,226,0
04:04:2014,ultraslim,http://click2hit.com/ultraslim,187,187,0
04:04:2014,umoris,http://click2hit.com/umoris,392,393,-1
04:04:2014,vantage,http://click2hit.com/vantage,518,0,518
04:04:2014,vapexecig,http://click2hit.com/vapexecig,337,337,0
04:04:2014,vimaxdetox,http://click2hit.com/vimaxdetox,873,874,-1
04:04:2014,virilityex,http://click2hit.com/virilityex,201,201,0
04:04:2014,vitaberryburn,http://click2hit.com/vitaberryburn,369,369,0
04:04:2014,vitaberrytrim,http://click2hit.com/vitaberrytrim,1795,1795,0
04:04:2014,vitacleanse,http://click2hit.com/vitacleanse,4373,4400,-27
04:04:2014,vitaketone,http://click2hit.com/vitaketone,911,918,-7
04:04:2014,vitalcleanse,http://click2hit.com/vitalcleanse,181,181,0
04:04:2014,vitalcleansecomplete,http://click2hit.com/vitalcleansecomplete,731,734,-3
04:04:2014,vitalifedetox,http://click2hit.com/vitalifedetox,722,732,-10
04:04:2014,vitalikortest,http://click2hit.com/vitalikortest,591,592,-1
04:04:2014,vitalipo,http://click2hit.com/vitalipo,115,117,-2
04:04:2014,vitalitygreencoffee,http://click2hit.com/vitalitygreencoffee,197,197,0
04:04:2014,vitamaxgarciniacambogia,http://click2hit.com/vitamaxgarciniacambogia,1701,1719,-18
04:04:2014,vyalis,http://click2hit.com/vyalis,230,232,-2
04:04:2014,wrinklerewind,http://click2hit.com/wrinklerewind,5595,5617,-22
04:04:2014,xmrecovery,http://click2hit.com/xmrecovery,139,141,-2
04:04:2014,xtremegarciniacambogia,http://click2hit.com/xtremegarciniacambogia,480,482,-2
04:04:2014,xtremenitro,http://click2hit.com/xtremenitro,1441,1468,-27
04:04:2014,xtremetestosteronebooster,http://click2hit.com/xtremetestosteronebooster,360,360,0
04:04:2014,yaconmolasses,http://click2hit.com/yaconmolasses,78,79,-1
04:04:2014,yaconrootmax,http://click2hit.com/yaconrootmax,878,916,-38
04:04:2014,yaconsyrupdirect,http://click2hit.com/yaconsyrupdirect,213,213,0
04:04:2014,yolosleep,http://click2hit.com/yolosleep,211,211,0
04:04:2014,youthkitantiaging,http://click2hit.com/youthkitantiaging,192,194,-2
04:04:2014,zenacose,http://click2hit.com/zenacose,161,161,0
04:04:2014,zenscleanse,http://click2hit.com/zenscleanse,2592,2599,-7
04:04:2014,zinncollection,http://click2hit.com/zinncollection,172,175,-3
04:04:2014,zolyria,http://click2hit.com/zolyria,469,473,-4
04:04:2014,zyloslim,http://click2hit.com/zyloslim,3708,3724,-16
04:04:2014,zymbiotix,http://click2hit.com/zymbiotix,1178,1193,-15
