dt_today,sitetitle,sitelink,pre_click,new_clicks,difrnce
12:04:2014,11fruits,http://goodpreview.info/11fruits,208,208,0
12:04:2014,1285muscle,http://goodpreview.info/1285muscle,2876,2876,0
12:04:2014,92trimgreencoffee,http://goodpreview.info/92trimgreencoffee,38,38,0
12:04:2014,Americig,http://goodpreview.info/Americig,475,479,-4
12:04:2014,Nuvagenic,http://goodpreview.info/Nuvagenic,1113,1113,0
12:04:2014,Prolexin,http://goodpreview.info/Prolexin,1044,1083,-39
12:04:2014,SVELME,http://goodpreview.info/SVELME,802,810,-8
12:04:2014,SlimSpray,http://goodpreview.info/SlimSpray,299,307,-8
12:04:2014,acaiberryfresh,http://goodpreview.info/acaiberryfresh,98,98,0
12:04:2014,acainatural,http://goodpreview.info/acainatural,133,133,0
12:04:2014,acaiultralean,http://goodpreview.info/acaiultralean,133,134,-1
12:04:2014,advancedgarciniacambogia,http://goodpreview.info/advancedgarciniacambogia,885,885,0
12:04:2014,advancedgarciniacambogia-fr,http://goodpreview.info/advancedgarciniacambogia-fr,154,157,-3
12:04:2014,advancedgarciniacambogia1,http://goodpreview.info/advancedgarciniacambogia1,39,40,-1
12:04:2014,advancedkrealkalyn,http://goodpreview.info/advancedkrealkalyn,148,148,0
12:04:2014,advancedpurecleanse,http://goodpreview.info/advancedpurecleanse,0,0,0
12:04:2014,advancedpurecleanse1,http://goodpreview.info/advancedpurecleanse1,48,51,-3
12:04:2014,africanmangoboost,http://goodpreview.info/africanmangoboost,118,118,0
12:04:2014,africanmangoprox,http://goodpreview.info/africanmangoprox,45,45,0
12:04:2014,africanmangopure,http://goodpreview.info/africanmangopure,77,77,0
12:04:2014,aktiveam,http://goodpreview.info/aktiveam,1612,1613,-1
12:04:2014,aktivepm,http://goodpreview.info/aktivepm,2053,2071,-18
12:04:2014,alphajacked,http://goodpreview.info/alphajacked,773,774,-1
12:04:2014,alphamaxplus,http://goodpreview.info/alphamaxplus,18,19,-1
12:04:2014,amazing,http://goodpreview.info/amazing,388,391,-3
12:04:2014,aminomuscle,http://goodpreview.info/aminomuscle,1225,1229,-4
12:04:2014,aminoprime,http://goodpreview.info/aminoprime,114,116,-2
12:04:2014,aminoprimexl,http://goodpreview.info/aminoprimexl,299,301,-2
12:04:2014,anabolicrx24,http://goodpreview.info/anabolicrx24,19411,19523,-112
12:04:2014,anatomyx5,http://goodpreview.info/anatomyx5,3,3,0
12:04:2014,androsolve,http://goodpreview.info/androsolve,1483,1487,-4
12:04:2014,androx,http://goodpreview.info/androx,14320,14407,-87
12:04:2014,anoradrol,http://goodpreview.info/anoradrol,222,224,-2
12:04:2014,auravie,http://goodpreview.info/auravie,106,106,0
12:04:2014,authenticgreencoffee,http://goodpreview.info/authenticgreencoffee,240,240,0
12:04:2014,beaudify,http://goodpreview.info/beaudify,75,75,0
12:04:2014,beautefxbbcream,http://goodpreview.info/beautefxbbcream,4,5,-1
12:04:2014,beautynectarcollagen,http://goodpreview.info/beautynectarcollagen,135,136,-1
12:04:2014,beddefense,http://goodpreview.info/beddefense,30,30,0
12:04:2014,bellagenix,http://goodpreview.info/bellagenix,138,138,0
12:04:2014,bellalabs,http://goodpreview.info/bellalabs,8,9,-1
12:04:2014,bellaplex,http://goodpreview.info/bellaplex,8,8,0
12:04:2014,beriultimatepro,http://goodpreview.info/beriultimatepro,69,69,0
12:04:2014,berrythin,http://goodpreview.info/berrythin,333,333,0
12:04:2014,betaalaninemax,http://goodpreview.info/betaalaninemax,0,0,0
12:04:2014,betaalaninextreme,http://goodpreview.info/betaalaninextreme,19,19,0
12:04:2014,beyondraspberry,http://goodpreview.info/beyondraspberry,77,77,0
12:04:2014,biohealthgarciniacambogia,http://goodpreview.info/biohealthgarciniacambogia,3782,0,3782
12:04:2014,biomelt,http://goodpreview.info/biomelt,368,373,-5
12:04:2014,blastxl,http://goodpreview.info/blastxl,174,180,-6
12:04:2014,bodycleanseplus,http://goodpreview.info/bodycleanseplus,67,67,0
12:04:2014,bodywrap,http://goodpreview.info/bodywrap,210,210,0
12:04:2014,breakfree,http://goodpreview.info/breakfree,114,115,-1
12:04:2014,cambogiatrim,http://goodpreview.info/cambogiatrim,601,601,0
12:04:2014,capsicum,http://goodpreview.info/capsicum,141,141,0
12:04:2014,celebritycleanser,http://goodpreview.info/celebritycleanser,359,388,-29
12:04:2014,celebrityraspberry,http://goodpreview.info/celebrityraspberry,149,151,-2
12:04:2014,cellanafricanmango,http://goodpreview.info/cellanafricanmango,270,270,0
12:04:2014,cellogicaskin,http://goodpreview.info/cellogicaskin,52,52,0
12:04:2014,centrislim,http://goodpreview.info/centrislim,199,199,0
12:04:2014,certifiedgreencoffee,http://goodpreview.info/certifiedgreencoffee,150,151,-1
12:04:2014,certifiedpuregreencoffee,http://goodpreview.info/certifiedpuregreencoffee,20,20,0
12:04:2014,chiocegreencoffee,http://goodpreview.info/chiocegreencoffee,545,545,0
12:04:2014,choicegreencoffee,http://goodpreview.info/choicegreencoffee,404,420,-16
12:04:2014,cleansefx,http://goodpreview.info/cleansefx,549,592,-43
12:04:2014,cleanseplus,http://goodpreview.info/cleanseplus,438,439,-1
12:04:2014,cleanseplus1,http://goodpreview.info/cleanseplus1,0,0,0
12:04:2014,cleansepremium,http://goodpreview.info/cleansepremium,16,16,0
12:04:2014,cleansewonder,http://goodpreview.info/cleansewonder,6,6,0
12:04:2014,cleansextrem,http://goodpreview.info/cleansextrem,422,446,-24
12:04:2014,cleantrim,http://goodpreview.info/cleantrim,231,231,0
12:04:2014,clearcleansepro,http://goodpreview.info/clearcleansepro,114,115,-1
12:04:2014,clearsmoke,http://goodpreview.info/clearsmoke,178,178,0
12:04:2014,codered7,http://goodpreview.info/codered7,331,333,-2
12:04:2014,coleanse,http://goodpreview.info/coleanse,126,127,-1
12:04:2014,collaton,http://goodpreview.info/collaton,90,90,0
12:04:2014,colocleansepro,http://goodpreview.info/colocleansepro,1,1,0
12:04:2014,coloncleansetotal,http://goodpreview.info/coloncleansetotal,23,24,-1
12:04:2014,colonpurecleanse,http://goodpreview.info/colonpurecleanse,133,133,0
12:04:2014,colothin,http://goodpreview.info/colothin,999,1000,-1
12:04:2014,completecoffeecleanse,http://goodpreview.info/completecoffeecleanse,1991,1995,-4
12:04:2014,complexiderm,http://goodpreview.info/complexiderm,111,111,0
12:04:2014,corecutter,http://goodpreview.info/corecutter,44,46,-2
12:04:2014,csorex,http://goodpreview.info/csorex,180,181,-1
12:04:2014,dailyfacelift,http://goodpreview.info/dailyfacelift,100,101,-1
12:04:2014,dailyfacestemcelltechnology,http://goodpreview.info/dailyfacestemcelltechnology,197,197,0
12:04:2014,dailypowercleanse,http://goodpreview.info/dailypowercleanse,133,135,-2
12:04:2014,deerantlerxtreme,http://goodpreview.info/deerantlerxtreme,137,138,-1
12:04:2014,dermarose,http://goodpreview.info/dermarose,115,115,0
12:04:2014,dermaset,http://goodpreview.info/dermaset,51,51,0
12:04:2014,dermpure,http://goodpreview.info/dermpure,80,80,0
12:04:2014,dietgreencoffeebean,http://goodpreview.info/dietgreencoffeebean,314,314,0
12:04:2014,drillpill,http://goodpreview.info/drillpill,459,460,-1
12:04:2014,elevategf,http://goodpreview.info/elevategf,178,180,-2
12:04:2014,elier,http://goodpreview.info/elier,51,52,-1
12:04:2014,elierskincare,http://goodpreview.info/elierskincare,41,41,0
12:04:2014,elitetest360,http://goodpreview.info/elitetest360,492,511,-19
12:04:2014,emeraldluxecig,http://goodpreview.info/emeraldluxecig,114,114,0
12:04:2014,enduros,http://goodpreview.info/enduros,995,1008,-13
12:04:2014,envigra,http://goodpreview.info/envigra,107,108,-1
12:04:2014,estrodetox,http://goodpreview.info/estrodetox,102,102,0
12:04:2014,extentxl,http://goodpreview.info/extentxl,178,181,-3
12:04:2014,fembalance,http://goodpreview.info/fembalance,17,17,0
12:04:2014,flawlessraspberryketone,http://goodpreview.info/flawlessraspberryketone,90,92,-2
12:04:2014,formulat10,http://goodpreview.info/formulat10,1523,1525,-2
12:04:2014,garcinaiawow1,http://goodpreview.info/garcinaiawow1,125,136,-11
12:04:2014,garciniacambogia,http://goodpreview.info/garciniacambogia,427,442,-15
12:04:2014,garciniacambogia1000,http://goodpreview.info/garciniacambogia1000,62,63,-1
12:04:2014,garciniacambogiaelite,http://goodpreview.info/garciniacambogiaelite,5360,5386,-26
12:04:2014,garciniacambogiafatbuster,http://goodpreview.info/garciniacambogiafatbuster,92,92,0
12:04:2014,garciniacambogiamax,http://goodpreview.info/garciniacambogiamax,2436,2439,-3
12:04:2014,garciniacambogiamiracle,http://goodpreview.info/garciniacambogiamiracle,132,132,0
12:04:2014,garciniacambogiapremium,http://goodpreview.info/garciniacambogiapremium,1076,1077,-1
12:04:2014,garciniacambogiapureextract,http://goodpreview.info/garciniacambogiapureextract,146,146,0
12:04:2014,garciniacambogiapureselect,http://goodpreview.info/garciniacambogiapureselect,4,7,-3
12:04:2014,garciniacambogiasupreme,http://goodpreview.info/garciniacambogiasupreme,3680,3765,-85
12:04:2014,garciniacambogiatoday,http://goodpreview.info/garciniacambogiatoday,144,145,-1
12:04:2014,garciniacambogiaultra,http://goodpreview.info/garciniacambogiaultra,379,382,-3
12:04:2014,garciniaforte,http://goodpreview.info/garciniaforte,91,110,-19
12:04:2014,garciniafreetrial,http://goodpreview.info/garciniafreetrial,69,69,0
12:04:2014,garciniagreen,http://goodpreview.info/garciniagreen,847,853,-6
12:04:2014,garciniapureelite1,http://goodpreview.info/garciniapureelite1,1,1,0
12:04:2014,garciniatoday,http://goodpreview.info/garciniatoday,0,0,0
12:04:2014,garciniatotal,http://goodpreview.info/garciniatotal,114,116,-2
12:04:2014,garciniawow,http://goodpreview.info/garciniawow,1100,1144,-44
12:04:2014,garcinium,http://goodpreview.info/garcinium,67,77,-10
12:04:2014,gc7x,http://goodpreview.info/gc7x,103,104,-1
12:04:2014,gc7xgreencoffee,http://goodpreview.info/gc7xgreencoffee,0,0,0
12:04:2014,gcbultra,http://goodpreview.info/gcbultra,53,53,0
12:04:2014,gcbx,http://goodpreview.info/gcbx,17109,17115,-6
12:04:2014,gcbx1,http://goodpreview.info/gcbx1,196,196,0
12:04:2014,gcspeedslim,http://goodpreview.info/gcspeedslim,5866,5880,-14
12:04:2014,gcultra,http://goodpreview.info/gcultra,137,137,0
12:04:2014,gcultragarcinia,http://goodpreview.info/gcultragarcinia,4,4,0
12:04:2014,geneme,http://goodpreview.info/geneme,40,40,0
12:04:2014,getnaturalgarcinia,http://goodpreview.info/getnaturalgarcinia,44,46,-2
12:04:2014,greencoffeeadvanced,http://goodpreview.info/greencoffeeadvanced,182,182,0
12:04:2014,greencoffeebean8000,http://goodpreview.info/greencoffeebean8000,67,67,0
12:04:2014,greencoffeebody,http://goodpreview.info/greencoffeebody,33,34,-1
12:04:2014,greencoffeeburn,http://goodpreview.info/greencoffeeburn,26,26,0
12:04:2014,greencoffeeextreme,http://goodpreview.info/greencoffeeextreme,85,85,0
12:04:2014,greencoffeemax,http://goodpreview.info/greencoffeemax,139,146,-7
12:04:2014,greencoffeemaxx,http://goodpreview.info/greencoffeemaxx,7,7,0
12:04:2014,greencoffeeoptimum,http://goodpreview.info/greencoffeeoptimum,125,125,0
12:04:2014,greencoffeeprogram,http://goodpreview.info/greencoffeeprogram,0,0,0
12:04:2014,greencoffeeultraslim,http://goodpreview.info/greencoffeeultraslim,210,211,-1
12:04:2014,greentonepro,http://goodpreview.info/greentonepro,310,311,-1
12:04:2014,healthetrimgarcinia,http://goodpreview.info/healthetrimgarcinia,156,156,0
12:04:2014,healthychoicegc,http://goodpreview.info/healthychoicegc,753,753,0
12:04:2014,horsepowerplusxxxl,http://goodpreview.info/horsepowerplusxxxl,307,320,-13
12:04:2014,hugegenic,http://goodpreview.info/hugegenic,376,381,-5
12:04:2014,hydrellatone,http://goodpreview.info/hydrellatone,105,105,0
12:04:2014,hydrocollagen,http://goodpreview.info/hydrocollagen,47,47,0
12:04:2014,hydroderm,http://goodpreview.info/hydroderm,47,48,-1
12:04:2014,hyperfuel9x,http://goodpreview.info/hyperfuel9x,1985,2004,-19
12:04:2014,illuminatedteeth,http://goodpreview.info/illuminatedteeth,56,62,-6
12:04:2014,instantwrinklerepair,http://goodpreview.info/instantwrinklerepair,18,18,0
12:04:2014,iqderma,http://goodpreview.info/iqderma,423,425,-2
12:04:2014,iqdermaessen,http://goodpreview.info/iqdermaessen,0,0,0
12:04:2014,ketoneoptimum,http://goodpreview.info/ketoneoptimum,156,157,-1
12:04:2014,kleanslim,http://goodpreview.info/kleanslim,100,102,-2
12:04:2014,lacreme,http://goodpreview.info/lacreme,81,100,-19
12:04:2014,leanmuscleformula,http://goodpreview.info/leanmuscleformula,63,74,-11
12:04:2014,ledermeluxe,http://goodpreview.info/ledermeluxe,187,187,0
12:04:2014,leparfait,http://goodpreview.info/leparfait,31,31,0
12:04:2014,leparisehydragold,http://goodpreview.info/leparisehydragold,6,7,-1
12:04:2014,levela,http://goodpreview.info/levela,107,109,-2
12:04:2014,lifedetox,http://goodpreview.info/lifedetox,146,146,0
12:04:2014,liftserumpro,http://goodpreview.info/liftserumpro,193,193,0
12:04:2014,liposlender,http://goodpreview.info/liposlender,29,29,0
12:04:2014,liposlim,http://goodpreview.info/liposlim,1921,1930,-9
12:04:2014,liposom,http://goodpreview.info/liposom,63,64,-1
12:04:2014,liveskinny,http://goodpreview.info/liveskinny,236,236,0
12:04:2014,lumahydrate,http://goodpreview.info/lumahydrate,433,446,-13
12:04:2014,lumarepair,http://goodpreview.info/lumarepair,516,526,-10
12:04:2014,lunathin,http://goodpreview.info/lunathin,129,129,0
12:04:2014,luxoderm,http://goodpreview.info/luxoderm,223,229,-6
12:04:2014,lysocleanse,http://goodpreview.info/lysocleanse,1853,1875,-22
12:04:2014,maxdetoxpro,http://goodpreview.info/maxdetoxpro,578,581,-3
12:04:2014,maxgarciniaburn,http://goodpreview.info/maxgarciniaburn,456,456,0
12:04:2014,maximumshred,http://goodpreview.info/maximumshred,1551,1560,-9
12:04:2014,maxrobust,http://goodpreview.info/maxrobust,266,271,-5
12:04:2014,maxrobustxtreme,http://goodpreview.info/maxrobustxtreme,523,523,0
12:04:2014,mightyraspberryketone,http://goodpreview.info/mightyraspberryketone,5124,5126,-2
12:04:2014,miraclegarciniacambogia,http://goodpreview.info/miraclegarciniacambogia,511,519,-8
12:04:2014,miraclegreencoffee,http://goodpreview.info/miraclegreencoffee,555,559,-4
12:04:2014,miraclesaffron,http://goodpreview.info/miraclesaffron,53,53,0
12:04:2014,mitoslim,http://goodpreview.info/mitoslim,2062,2064,-2
12:04:2014,musclefactorx,http://goodpreview.info/musclefactorx,1449,1450,-1
12:04:2014,musclefactorx-1,http://goodpreview.info/musclefactorx-1,22,22,0
12:04:2014,musclekingpro,http://goodpreview.info/musclekingpro,504,504,0
12:04:2014,musclemaxextreme,http://goodpreview.info/musclemaxextreme,137,137,0
12:04:2014,muscleplus,http://goodpreview.info/muscleplus,143,144,-1
12:04:2014,musclerevolutionpro,http://goodpreview.info/musclerevolutionpro,1444,1450,-6
12:04:2014,musclerevx,http://goodpreview.info/musclerevx,107,108,-1
12:04:2014,musclerevxtreme,http://goodpreview.info/musclerevxtreme,66,68,-2
12:04:2014,musclexlerator,http://goodpreview.info/musclexlerator,32,35,-3
12:04:2014,musclexmax,http://goodpreview.info/musclexmax,1467,1470,-3
12:04:2014,musclexmax1,http://goodpreview.info/musclexmax1,280,280,0
12:04:2014,musclezx90,http://goodpreview.info/musclezx90,5018,5020,-2
12:04:2014,naturalcleanse,http://goodpreview.info/naturalcleanse,8064,8090,-26
12:04:2014,naturalgarciniacambogia,http://goodpreview.info/naturalgarciniacambogia,2779,2784,-5
12:04:2014,naturalgreencoffee,http://goodpreview.info/naturalgreencoffee,9,9,0
12:04:2014,naturalhealthgarcinia,http://goodpreview.info/naturalhealthgarcinia,54,56,-2
12:04:2014,naturalpurecleanse,http://goodpreview.info/naturalpurecleanse,34,50,-16
12:04:2014,nauseam,http://goodpreview.info/nauseam,135,136,-1
12:04:2014,nauseamplus,http://goodpreview.info/nauseamplus,0,0,0
12:04:2014,nextrim,http://goodpreview.info/nextrim,1747,1757,-10
12:04:2014,nitricmusclemax,http://goodpreview.info/nitricmusclemax,14838,14942,-104
12:04:2014,nitrofocusno3,http://goodpreview.info/nitrofocusno3,114,116,-2
12:04:2014,niwali,http://goodpreview.info/niwali,841,844,-3
12:04:2014,no2explodeextreme,http://goodpreview.info/no2explodeextreme,164,164,0
12:04:2014,no2extremerush,http://goodpreview.info/no2extremerush,1314,1315,-1
12:04:2014,noflameecigs,http://goodpreview.info/noflameecigs,350,350,0
12:04:2014,nuclearno,http://goodpreview.info/nuclearno,369,370,-1
12:04:2014,nuetrim,http://goodpreview.info/nuetrim,660,660,0
12:04:2014,nutragreencoffee,http://goodpreview.info/nutragreencoffee,22,26,-4
12:04:2014,nutrapuregarcinia,http://goodpreview.info/nutrapuregarcinia,216,216,0
12:04:2014,nutratoneplus,http://goodpreview.info/nutratoneplus,1007,1010,-3
12:04:2014,nutriberryslim,http://goodpreview.info/nutriberryslim,1318,1360,-42
12:04:2014,nuvoryn,http://goodpreview.info/nuvoryn,22,22,0
12:04:2014,optimalstack,http://goodpreview.info/optimalstack,1750,1771,-21
12:04:2014,optimummuscle,http://goodpreview.info/optimummuscle,209,209,0
12:04:2014,organicgreencoffee,http://goodpreview.info/organicgreencoffee,91,91,0
12:04:2014,organicwhitekidneybean,http://goodpreview.info/organicwhitekidneybean,91,91,0
12:04:2014,orviax,http://goodpreview.info/orviax,89,89,0
12:04:2014,oxitamin,http://goodpreview.info/oxitamin,149,149,0
12:04:2014,phtytoceramides,http://goodpreview.info/phtytoceramides,832,837,-5
12:04:2014,powerigf,http://goodpreview.info/powerigf,1946,1974,-28
12:04:2014,powerpumpxl,http://goodpreview.info/powerpumpxl,371,372,-1
12:04:2014,powerup,http://goodpreview.info/powerup,121,121,0
12:04:2014,premiermangocleanse,http://goodpreview.info/premiermangocleanse,520,521,-1
12:04:2014,premiumcleanse,http://goodpreview.info/premiumcleanse,2816,2828,-12
12:04:2014,premiumgarciniacambogia,http://goodpreview.info/premiumgarciniacambogia,404,404,0
12:04:2014,premiumgarciniaextract,http://goodpreview.info/premiumgarciniaextract,715,715,0
12:04:2014,premiumgreencoffee,http://goodpreview.info/premiumgreencoffee,122,123,-1
12:04:2014,premiumgreencoffee800,http://goodpreview.info/premiumgreencoffee800,108,109,-1
12:04:2014,premiumraspberryketone,http://goodpreview.info/premiumraspberryketone,44,44,0
12:04:2014,primalitegarciniaextract,http://goodpreview.info/primalitegarciniaextract,782,797,-15
12:04:2014,progain350,http://goodpreview.info/progain350,281,304,-23
12:04:2014,prograce,http://goodpreview.info/prograce,6,6,0
12:04:2014,promusclecomplex,http://goodpreview.info/promusclecomplex,49,49,0
12:04:2014,propowercleanse,http://goodpreview.info/propowercleanse,1272,1290,-18
12:04:2014,pureberrymax,http://goodpreview.info/pureberrymax,216,216,0
12:04:2014,purecleansehealth,http://goodpreview.info/purecleansehealth,111,112,-1
12:04:2014,purecollagen,http://goodpreview.info/purecollagen,2230,2233,-3
12:04:2014,puregarciniacambogia,http://goodpreview.info/puregarciniacambogia,1220,1221,-1
12:04:2014,puregarciniaslim,http://goodpreview.info/puregarciniaslim,175,175,0
12:04:2014,puregreencoffeebeanextract,http://goodpreview.info/puregreencoffeebeanextract,2740,2746,-6
12:04:2014,puregreencoffeemaxima,http://goodpreview.info/puregreencoffeemaxima,37,37,0
12:04:2014,puregriffonia,http://goodpreview.info/puregriffonia,97,97,0
12:04:2014,pureketoneslim,http://goodpreview.info/pureketoneslim,34,34,0
12:04:2014,purelifeclanse,http://goodpreview.info/purelifeclanse,18,23,-5
12:04:2014,puremusclepro,http://goodpreview.info/puremusclepro,1811,1811,0
12:04:2014,purenaturalcleanser,http://goodpreview.info/purenaturalcleanser,484,485,-1
12:04:2014,purephytoceramides,http://goodpreview.info/purephytoceramides,79,83,-4
12:04:2014,pureraspberryketonepremium,http://goodpreview.info/pureraspberryketonepremium,64,64,0
12:04:2014,puresaffronslim,http://goodpreview.info/puresaffronslim,424,425,-1
12:04:2014,pureslim57,http://goodpreview.info/pureslim57,131,131,0
12:04:2014,purgarciniacambogia,http://goodpreview.info/purgarciniacambogia,158,158,0
12:04:2014,purgreencoffee,http://goodpreview.info/purgreencoffee,1629,1629,0
12:04:2014,purifyre,http://goodpreview.info/purifyre,244,245,-1
12:04:2014,purifyregreencoffee,http://goodpreview.info/purifyregreencoffee,0,0,0
12:04:2014,raspberryhealth,http://goodpreview.info/raspberryhealth,72,72,0
12:04:2014,raspberryketoneblast,http://goodpreview.info/raspberryketoneblast,4577,4639,-62
12:04:2014,raspberryketoned,http://goodpreview.info/raspberryketoned,8,8,0
12:04:2014,raspberryketoneoptimum,http://goodpreview.info/raspberryketoneoptimum,5,5,0
12:04:2014,raspberryketonepremium,http://goodpreview.info/raspberryketonepremium,79,80,-1
12:04:2014,raspberryketonepure,http://goodpreview.info/raspberryketonepure,2,2,0
12:04:2014,raspberryketonethin,http://goodpreview.info/raspberryketonethin,75,92,-17
12:04:2014,raspberryslimplus,http://goodpreview.info/raspberryslimplus,131,131,0
12:04:2014,refuelextreme,http://goodpreview.info/refuelextreme,529,535,-6
12:04:2014,regalecig,http://goodpreview.info/regalecig,384,387,-3
12:04:2014,regalecigs,http://goodpreview.info/regalecigs,44,45,-1
12:04:2014,rejuvaglow,http://goodpreview.info/rejuvaglow,71,72,-1
12:04:2014,rejuveneyemax,http://goodpreview.info/rejuveneyemax,127,141,-14
12:04:2014,rellift,http://goodpreview.info/rellift,30,30,0
12:04:2014,renovo,http://goodpreview.info/renovo,43,45,-2
12:04:2014,restiflex,http://goodpreview.info/restiflex,65,66,-1
12:04:2014,revitalize,http://goodpreview.info/revitalize,26,26,0
12:04:2014,revitatone,http://goodpreview.info/revitatone,9145,9194,-49
12:04:2014,revolutionaryraspberryketone,http://goodpreview.info/revolutionaryraspberryketone,65,65,0
12:04:2014,revoreplex,http://goodpreview.info/revoreplex,23,23,0
12:04:2014,revtesttestosterone,http://goodpreview.info/revtesttestosterone,1597,1599,-2
12:04:2014,rippedmusclex,http://goodpreview.info/rippedmusclex,219,225,-6
12:04:2014,rippedxburn,http://goodpreview.info/rippedxburn,198,198,0
12:04:2014,sacredarganoil,http://goodpreview.info/sacredarganoil,49,49,0
12:04:2014,safercolon,http://goodpreview.info/safercolon,3446,3483,-37
12:04:2014,saffronextractpremium,http://goodpreview.info/saffronextractpremium,108,110,-2
12:04:2014,saffronextractselect,http://goodpreview.info/saffronextractselect,1388,1392,-4
12:04:2014,saffronselect,http://goodpreview.info/saffronselect,77,77,0
12:04:2014,secretgreencoffee,http://goodpreview.info/secretgreencoffee,283,286,-3
12:04:2014,simpleantiaging,http://goodpreview.info/simpleantiaging,231,231,0
12:04:2014,simplygarcinia,http://goodpreview.info/simplygarcinia,1235,1250,-15
12:04:2014,skinlift,http://goodpreview.info/skinlift,2159,2161,-2
12:04:2014,slendera,http://goodpreview.info/slendera,15,15,0
12:04:2014,slenderagc-1,http://goodpreview.info/slenderagc-1,431,437,-6
12:04:2014,slimatrex,http://goodpreview.info/slimatrex,624,625,-1
12:04:2014,slimhelper,http://goodpreview.info/slimhelper,247,248,-1
12:04:2014,slimher,http://goodpreview.info/slimher,172,172,0
12:04:2014,slimmeryougarcinia,http://goodpreview.info/slimmeryougarcinia,0,0,0
12:04:2014,slimtropical,http://goodpreview.info/slimtropical,815,819,-4
12:04:2014,slimtropicalmx,http://goodpreview.info/slimtropicalmx,136,136,0
12:04:2014,slimzenu,http://goodpreview.info/slimzenu,201,201,0
12:04:2014,smokestarecig,http://goodpreview.info/smokestarecig,562,564,-2
12:04:2014,solpriaxtreme,http://goodpreview.info/solpriaxtreme,2804,2811,-7
12:04:2014,sorepressin,http://goodpreview.info/sorepressin,6,6,0
12:04:2014,speedtrimxs,http://goodpreview.info/speedtrimxs,95,95,0
12:04:2014,splendyr,http://goodpreview.info/splendyr,1277,1279,-2
12:04:2014,splendyrantiaging,http://goodpreview.info/splendyrantiaging,52,52,0
12:04:2014,superacaicleanse,http://goodpreview.info/superacaicleanse,23,23,0
12:04:2014,supercleansetotal,http://goodpreview.info/supercleansetotal,99,102,-3
12:04:2014,supergreencoffee,http://goodpreview.info/supergreencoffee,11,11,0
12:04:2014,supergreencoffeebean,http://goodpreview.info/supergreencoffeebean,20,20,0
12:04:2014,superiormusclex,http://goodpreview.info/superiormusclex,49,49,0
12:04:2014,superiorvelvet,http://goodpreview.info/superiorvelvet,1,1,0
12:04:2014,superyacon1000,http://goodpreview.info/superyacon1000,27,27,0
12:04:2014,supracleanse350,http://goodpreview.info/supracleanse350,0,0,0
12:04:2014,supragreencoffee,http://goodpreview.info/supragreencoffee,962,965,-3
12:04:2014,supragreencoffeebean,http://goodpreview.info/supragreencoffeebean,0,0,0
12:04:2014,surelyyoung,http://goodpreview.info/surelyyoung,32,32,0
12:04:2014,swissrose,http://goodpreview.info/swissrose,349,349,0
12:04:2014,swolekreate,http://goodpreview.info/swolekreate,194,196,-2
12:04:2014,syneocell,http://goodpreview.info/syneocell,63,64,-1
12:04:2014,t-force,http://goodpreview.info/t-force,214,217,-3
12:04:2014,testforcextreme,http://goodpreview.info/testforcextreme,493,493,0
12:04:2014,testoforce,http://goodpreview.info/testoforce,25,25,0
12:04:2014,testorushrx,http://goodpreview.info/testorushrx,43,43,0
12:04:2014,testosteronemax,http://goodpreview.info/testosteronemax,333,333,0
12:04:2014,testoxl,http://goodpreview.info/testoxl,1491,1495,-4
12:04:2014,thinmagic,http://goodpreview.info/thinmagic,279,282,-3
12:04:2014,thinmagicmax,http://goodpreview.info/thinmagicmax,0,0,0
12:04:2014,thinsport,http://goodpreview.info/thinsport,212,212,0
12:04:2014,titaniumprox,http://goodpreview.info/titaniumprox,0,0,0
12:04:2014,totalbodyfresh,http://goodpreview.info/totalbodyfresh,136,143,-7
12:04:2014,trigx2,http://goodpreview.info/trigx2,18,21,-3
12:04:2014,trimaleana,http://goodpreview.info/trimaleana,142,142,0
12:04:2014,trimatol,http://goodpreview.info/trimatol,126,126,0
12:04:2014,trimblendgarciniacambogia,http://goodpreview.info/trimblendgarciniacambogia,79,80,-1
12:04:2014,triminexgarciniacambogia,http://goodpreview.info/triminexgarciniacambogia,98,98,0
12:04:2014,triminexgreencoffee,http://goodpreview.info/triminexgreencoffee,62,79,-17
12:04:2014,tripleeffectseyeserum,http://goodpreview.info/tripleeffectseyeserum,621,623,-2
12:04:2014,turboextracut,http://goodpreview.info/turboextracut,162,162,0
12:04:2014,turboshred,http://goodpreview.info/turboshred,100,100,0
12:04:2014,ultimategarcinia,http://goodpreview.info/ultimategarcinia,165,165,0
12:04:2014,ultramaxtestosterone,http://goodpreview.info/ultramaxtestosterone,33,33,0
12:04:2014,ultrapurecoloncleanse,http://goodpreview.info/ultrapurecoloncleanse,8,10,-2
12:04:2014,ultraraspberryketone,http://goodpreview.info/ultraraspberryketone,420,420,0
12:04:2014,velora,http://goodpreview.info/velora,23,23,0
12:04:2014,velveskin,http://goodpreview.info/velveskin,21,21,0
12:04:2014,vencleanse,http://goodpreview.info/vencleanse,433,433,0
12:04:2014,viarex,http://goodpreview.info/viarex,624,630,-6
12:04:2014,vitalifedetox,http://goodpreview.info/vitalifedetox,261,261,0
12:04:2014,vitalitygreencoffee,http://goodpreview.info/vitalitygreencoffee,86,86,0
12:04:2014,vitamax,http://goodpreview.info/vitamax,25,25,0
12:04:2014,vitolipo,http://goodpreview.info/vitolipo,1172,1175,-3
12:04:2014,vydox,http://goodpreview.info/vydox,328,330,-2
12:04:2014,wildraspberryketone,http://goodpreview.info/wildraspberryketone,208,213,-5
12:04:2014,wrinklesscream,http://goodpreview.info/wrinklesscream,317,330,-13
12:04:2014,xenaslim,http://goodpreview.info/xenaslim,42,42,0
12:04:2014,xengthx1,http://goodpreview.info/xengthx1,43,44,-1
12:04:2014,xlerator,http://goodpreview.info/xlerator,0,0,0
12:04:2014,xocigs,http://goodpreview.info/xocigs,65,65,0
12:04:2014,xtgenix,http://goodpreview.info/xtgenix,13013,13016,-3
12:04:2014,xtrememusclepro,http://goodpreview.info/xtrememusclepro,616,618,-2
12:04:2014,yaconsplash,http://goodpreview.info/yaconsplash,25,26,-1
12:04:2014,yaconsyruporiginal,http://goodpreview.info/yaconsyruporiginal,96,96,0
12:04:2014,yaconsyrupsecret,http://goodpreview.info/yaconsyrupsecret,36,36,0
12:04:2014,yoloboost,http://goodpreview.info/yoloboost,25,29,-4
12:04:2014,youthkiteyecream,http://goodpreview.info/youthkiteyecream,246,247,-1
