dt_today,sitetitle,sitelink,pre_click,new_clicks,difrnce
08:04:2014,11fruits,http://goodpreview.info/11fruits,200,200,0
08:04:2014,1285muscle,http://goodpreview.info/1285muscle,2869,2872,-3
08:04:2014,92trimgreencoffee,http://goodpreview.info/92trimgreencoffee,36,37,-1
08:04:2014,Americig,http://goodpreview.info/Americig,449,463,-14
08:04:2014,Nuvagenic,http://goodpreview.info/Nuvagenic,1102,1104,-2
08:04:2014,Prolexin,http://goodpreview.info/Prolexin,850,891,-41
08:04:2014,SVELME,http://goodpreview.info/SVELME,796,800,-4
08:04:2014,SlimSpray,http://goodpreview.info/SlimSpray,280,288,-8
08:04:2014,acaiberryfresh,http://goodpreview.info/acaiberryfresh,98,98,0
08:04:2014,acainatural,http://goodpreview.info/acainatural,133,133,0
08:04:2014,acaiultralean,http://goodpreview.info/acaiultralean,132,132,0
08:04:2014,advancedgarciniacambogia,http://goodpreview.info/advancedgarciniacambogia,884,884,0
08:04:2014,advancedgarciniacambogia-fr,http://goodpreview.info/advancedgarciniacambogia-fr,130,137,-7
08:04:2014,advancedgarciniacambogia1,http://goodpreview.info/advancedgarciniacambogia1,31,34,-3
08:04:2014,advancedkrealkalyn,http://goodpreview.info/advancedkrealkalyn,146,147,-1
08:04:2014,advancedpurecleanse,http://goodpreview.info/advancedpurecleanse,0,0,0
08:04:2014,advancedpurecleanse1,http://goodpreview.info/advancedpurecleanse1,34,37,-3
08:04:2014,africanmangoboost,http://goodpreview.info/africanmangoboost,118,118,0
08:04:2014,africanmangoprox,http://goodpreview.info/africanmangoprox,43,43,0
08:04:2014,africanmangopure,http://goodpreview.info/africanmangopure,77,77,0
08:04:2014,aktiveam,http://goodpreview.info/aktiveam,1607,1609,-2
08:04:2014,aktivepm,http://goodpreview.info/aktivepm,2028,2033,-5
08:04:2014,alphajacked,http://goodpreview.info/alphajacked,773,773,0
08:04:2014,alphamaxplus,http://goodpreview.info/alphamaxplus,18,18,0
08:04:2014,amazing,http://goodpreview.info/amazing,367,371,-4
08:04:2014,aminomuscle,http://goodpreview.info/aminomuscle,1204,1208,-4
08:04:2014,aminoprime,http://goodpreview.info/aminoprime,112,113,-1
08:04:2014,aminoprimexl,http://goodpreview.info/aminoprimexl,288,290,-2
08:04:2014,anabolicrx24,http://goodpreview.info/anabolicrx24,18401,18674,-273
08:04:2014,anatomyx5,http://goodpreview.info/anatomyx5,3,3,0
08:04:2014,androsolve,http://goodpreview.info/androsolve,1478,1478,0
08:04:2014,androx,http://goodpreview.info/androx,13785,13881,-96
08:04:2014,anoradrol,http://goodpreview.info/anoradrol,218,218,0
08:04:2014,auravie,http://goodpreview.info/auravie,105,105,0
08:04:2014,authenticgreencoffee,http://goodpreview.info/authenticgreencoffee,240,240,0
08:04:2014,beaudify,http://goodpreview.info/beaudify,75,75,0
08:04:2014,beautefxbbcream,http://goodpreview.info/beautefxbbcream,3,3,0
08:04:2014,beautynectarcollagen,http://goodpreview.info/beautynectarcollagen,133,134,-1
08:04:2014,beddefense,http://goodpreview.info/beddefense,28,28,0
08:04:2014,bellagenix,http://goodpreview.info/bellagenix,138,138,0
08:04:2014,bellalabs,http://goodpreview.info/bellalabs,8,8,0
08:04:2014,bellaplex,http://goodpreview.info/bellaplex,7,7,0
08:04:2014,beriultimatepro,http://goodpreview.info/beriultimatepro,68,69,-1
08:04:2014,berrythin,http://goodpreview.info/berrythin,332,332,0
08:04:2014,betaalaninemax,http://goodpreview.info/betaalaninemax,0,0,0
08:04:2014,betaalaninextreme,http://goodpreview.info/betaalaninextreme,18,18,0
08:04:2014,beyondraspberry,http://goodpreview.info/beyondraspberry,75,77,-2
08:04:2014,biohealthgarciniacambogia,http://goodpreview.info/biohealthgarciniacambogia,3618,3682,-64
08:04:2014,biomelt,http://goodpreview.info/biomelt,355,361,-6
08:04:2014,blastxl,http://goodpreview.info/blastxl,167,170,-3
08:04:2014,bodycleanseplus,http://goodpreview.info/bodycleanseplus,66,66,0
08:04:2014,bodywrap,http://goodpreview.info/bodywrap,207,209,-2
08:04:2014,breakfree,http://goodpreview.info/breakfree,112,113,-1
08:04:2014,cambogiatrim,http://goodpreview.info/cambogiatrim,598,598,0
08:04:2014,capsicum,http://goodpreview.info/capsicum,140,140,0
08:04:2014,celebritycleanser,http://goodpreview.info/celebritycleanser,152,168,-16
08:04:2014,celebrityraspberry,http://goodpreview.info/celebrityraspberry,144,145,-1
08:04:2014,cellanafricanmango,http://goodpreview.info/cellanafricanmango,263,265,-2
08:04:2014,cellogicaskin,http://goodpreview.info/cellogicaskin,50,51,-1
08:04:2014,centrislim,http://goodpreview.info/centrislim,199,199,0
08:04:2014,certifiedgreencoffee,http://goodpreview.info/certifiedgreencoffee,149,149,0
08:04:2014,certifiedpuregreencoffee,http://goodpreview.info/certifiedpuregreencoffee,19,19,0
08:04:2014,chiocegreencoffee,http://goodpreview.info/chiocegreencoffee,545,545,0
08:04:2014,choicegreencoffee,http://goodpreview.info/choicegreencoffee,378,385,-7
08:04:2014,cleansefx,http://goodpreview.info/cleansefx,314,396,-82
08:04:2014,cleanseplus,http://goodpreview.info/cleanseplus,431,432,-1
08:04:2014,cleanseplus1,http://goodpreview.info/cleanseplus1,0,0,0
08:04:2014,cleansepremium,http://goodpreview.info/cleansepremium,15,15,0
08:04:2014,cleansewonder,http://goodpreview.info/cleansewonder,206,206,0
08:04:2014,cleansextrem,http://goodpreview.info/cleansextrem,234,293,-59
08:04:2014,cleantrim,http://goodpreview.info/cleantrim,228,229,-1
08:04:2014,clearcleansepro,http://goodpreview.info/clearcleansepro,111,112,-1
08:04:2014,clearsmoke,http://goodpreview.info/clearsmoke,177,177,0
08:04:2014,codered7,http://goodpreview.info/codered7,312,314,-2
08:04:2014,coleanse,http://goodpreview.info/coleanse,124,124,0
08:04:2014,collaton,http://goodpreview.info/collaton,88,88,0
08:04:2014,colocleansepro,http://goodpreview.info/colocleansepro,1,1,0
08:04:2014,coloncleansetotal,http://goodpreview.info/coloncleansetotal,20,21,-1
08:04:2014,colonpurecleanse,http://goodpreview.info/colonpurecleanse,132,133,-1
08:04:2014,colothin,http://goodpreview.info/colothin,991,992,-1
08:04:2014,completecoffeecleanse,http://goodpreview.info/completecoffeecleanse,1982,1987,-5
08:04:2014,complexiderm,http://goodpreview.info/complexiderm,105,109,-4
08:04:2014,corecutter,http://goodpreview.info/corecutter,38,41,-3
08:04:2014,csorex,http://goodpreview.info/csorex,179,179,0
08:04:2014,dailyfacelift,http://goodpreview.info/dailyfacelift,99,99,0
08:04:2014,dailyfacestemcelltechnology,http://goodpreview.info/dailyfacestemcelltechnology,196,196,0
08:04:2014,dailypowercleanse,http://goodpreview.info/dailypowercleanse,121,128,-7
08:04:2014,deerantlerxtreme,http://goodpreview.info/deerantlerxtreme,132,134,-2
08:04:2014,dermarose,http://goodpreview.info/dermarose,112,113,-1
08:04:2014,dermaset,http://goodpreview.info/dermaset,51,51,0
08:04:2014,dermpure,http://goodpreview.info/dermpure,80,80,0
08:04:2014,dietgreencoffeebean,http://goodpreview.info/dietgreencoffeebean,312,312,0
08:04:2014,drillpill,http://goodpreview.info/drillpill,458,458,0
08:04:2014,elevategf,http://goodpreview.info/elevategf,174,178,-4
08:04:2014,elier,http://goodpreview.info/elier,50,50,0
08:04:2014,elierskincare,http://goodpreview.info/elierskincare,41,41,0
08:04:2014,elitetest360,http://goodpreview.info/elitetest360,458,466,-8
08:04:2014,emeraldluxecig,http://goodpreview.info/emeraldluxecig,113,113,0
08:04:2014,enduros,http://goodpreview.info/enduros,979,985,-6
08:04:2014,envigra,http://goodpreview.info/envigra,106,106,0
08:04:2014,estrodetox,http://goodpreview.info/estrodetox,99,100,-1
08:04:2014,extentxl,http://goodpreview.info/extentxl,176,176,0
08:04:2014,fembalance,http://goodpreview.info/fembalance,17,17,0
08:04:2014,flawlessraspberryketone,http://goodpreview.info/flawlessraspberryketone,84,90,-6
08:04:2014,formulat10,http://goodpreview.info/formulat10,1513,1513,0
08:04:2014,garcinaiawow1,http://goodpreview.info/garcinaiawow1,63,84,-21
08:04:2014,garciniacambogia,http://goodpreview.info/garciniacambogia,299,344,-45
08:04:2014,garciniacambogia1000,http://goodpreview.info/garciniacambogia1000,62,62,0
08:04:2014,garciniacambogiaelite,http://goodpreview.info/garciniacambogiaelite,5291,5313,-22
08:04:2014,garciniacambogiafatbuster,http://goodpreview.info/garciniacambogiafatbuster,90,91,-1
08:04:2014,garciniacambogiamax,http://goodpreview.info/garciniacambogiamax,2408,2411,-3
08:04:2014,garciniacambogiamiracle,http://goodpreview.info/garciniacambogiamiracle,129,130,-1
08:04:2014,garciniacambogiapremium,http://goodpreview.info/garciniacambogiapremium,1076,1076,0
08:04:2014,garciniacambogiapureextract,http://goodpreview.info/garciniacambogiapureextract,144,145,-1
08:04:2014,garciniacambogiapureselect,http://goodpreview.info/garciniacambogiapureselect,599,602,-3
08:04:2014,garciniacambogiasupreme,http://goodpreview.info/garciniacambogiasupreme,3316,3404,-88
08:04:2014,garciniacambogiatoday,http://goodpreview.info/garciniacambogiatoday,136,140,-4
08:04:2014,garciniacambogiaultra,http://goodpreview.info/garciniacambogiaultra,362,366,-4
08:04:2014,garciniaforte,http://goodpreview.info/garciniaforte,55,65,-10
08:04:2014,garciniafreetrial,http://goodpreview.info/garciniafreetrial,69,69,0
08:04:2014,garciniagreen,http://goodpreview.info/garciniagreen,841,843,-2
08:04:2014,garciniapureelite1,http://goodpreview.info/garciniapureelite1,1,1,0
08:04:2014,garciniatoday,http://goodpreview.info/garciniatoday,0,0,0
08:04:2014,garciniatotal,http://goodpreview.info/garciniatotal,95,100,-5
08:04:2014,garciniawow,http://goodpreview.info/garciniawow,970,999,-29
08:04:2014,garcinium,http://goodpreview.info/garcinium,22,38,-16
08:04:2014,gc7x,http://goodpreview.info/gc7x,102,103,-1
08:04:2014,gc7xgreencoffee,http://goodpreview.info/gc7xgreencoffee,0,0,0
08:04:2014,gcbultra,http://goodpreview.info/gcbultra,52,52,0
08:04:2014,gcbx,http://goodpreview.info/gcbx,17085,17094,-9
08:04:2014,gcbx1,http://goodpreview.info/gcbx1,196,196,0
08:04:2014,gcspeedslim,http://goodpreview.info/gcspeedslim,5783,5794,-11
08:04:2014,gcultra,http://goodpreview.info/gcultra,136,137,-1
08:04:2014,gcultragarcinia,http://goodpreview.info/gcultragarcinia,4,4,0
08:04:2014,geneme,http://goodpreview.info/geneme,40,40,0
08:04:2014,getnaturalgarcinia,http://goodpreview.info/getnaturalgarcinia,41,41,0
08:04:2014,greencoffeeadvanced,http://goodpreview.info/greencoffeeadvanced,181,181,0
08:04:2014,greencoffeebean8000,http://goodpreview.info/greencoffeebean8000,66,66,0
08:04:2014,greencoffeebody,http://goodpreview.info/greencoffeebody,33,33,0
08:04:2014,greencoffeeburn,http://goodpreview.info/greencoffeeburn,25,25,0
08:04:2014,greencoffeeextreme,http://goodpreview.info/greencoffeeextreme,84,84,0
08:04:2014,greencoffeemax,http://goodpreview.info/greencoffeemax,135,137,-2
08:04:2014,greencoffeemaxx,http://goodpreview.info/greencoffeemaxx,4,5,-1
08:04:2014,greencoffeeoptimum,http://goodpreview.info/greencoffeeoptimum,123,125,-2
08:04:2014,greencoffeeprogram,http://goodpreview.info/greencoffeeprogram,0,0,0
08:04:2014,greencoffeeultraslim,http://goodpreview.info/greencoffeeultraslim,207,208,-1
08:04:2014,greentonepro,http://goodpreview.info/greentonepro,309,309,0
08:04:2014,healthetrimgarcinia,http://goodpreview.info/healthetrimgarcinia,151,154,-3
08:04:2014,healthychoicegc,http://goodpreview.info/healthychoicegc,747,748,-1
08:04:2014,horsepowerplusxxxl,http://goodpreview.info/horsepowerplusxxxl,245,257,-12
08:04:2014,hugegenic,http://goodpreview.info/hugegenic,329,350,-21
08:04:2014,hydrellatone,http://goodpreview.info/hydrellatone,103,103,0
08:04:2014,hydrocollagen,http://goodpreview.info/hydrocollagen,44,45,-1
08:04:2014,hydroderm,http://goodpreview.info/hydroderm,47,47,0
08:04:2014,hyperfuel9x,http://goodpreview.info/hyperfuel9x,1932,1948,-16
08:04:2014,illuminatedteeth,http://goodpreview.info/illuminatedteeth,44,46,-2
08:04:2014,instantwrinklerepair,http://goodpreview.info/instantwrinklerepair,18,18,0
08:04:2014,iqderma,http://goodpreview.info/iqderma,419,419,0
08:04:2014,iqdermaessen,http://goodpreview.info/iqdermaessen,0,0,0
08:04:2014,ketoneoptimum,http://goodpreview.info/ketoneoptimum,155,155,0
08:04:2014,kleanslim,http://goodpreview.info/kleanslim,100,100,0
08:04:2014,lacreme,http://goodpreview.info/lacreme,0,7,-7
08:04:2014,leanmuscleformula,http://goodpreview.info/leanmuscleformula,48,54,-6
08:04:2014,ledermeluxe,http://goodpreview.info/ledermeluxe,185,185,0
08:04:2014,leparfait,http://goodpreview.info/leparfait,21,21,0
08:04:2014,leparisehydragold,http://goodpreview.info/leparisehydragold,3,4,-1
08:04:2014,levela,http://goodpreview.info/levela,105,106,-1
08:04:2014,lifedetox,http://goodpreview.info/lifedetox,146,146,0
08:04:2014,liftserumpro,http://goodpreview.info/liftserumpro,189,189,0
08:04:2014,liposlender,http://goodpreview.info/liposlender,25,26,-1
08:04:2014,liposlim,http://goodpreview.info/liposlim,1878,1885,-7
08:04:2014,liposom,http://goodpreview.info/liposom,62,62,0
08:04:2014,liveskinny,http://goodpreview.info/liveskinny,232,233,-1
08:04:2014,lumahydrate,http://goodpreview.info/lumahydrate,406,413,-7
08:04:2014,lumarepair,http://goodpreview.info/lumarepair,483,497,-14
08:04:2014,lunathin,http://goodpreview.info/lunathin,123,127,-4
08:04:2014,luxoderm,http://goodpreview.info/luxoderm,210,213,-3
08:04:2014,lysocleanse,http://goodpreview.info/lysocleanse,1794,1811,-17
08:04:2014,maxdetoxpro,http://goodpreview.info/maxdetoxpro,574,574,0
08:04:2014,maxgarciniaburn,http://goodpreview.info/maxgarciniaburn,455,455,0
08:04:2014,maximumshred,http://goodpreview.info/maximumshred,1523,1532,-9
08:04:2014,maxrobust,http://goodpreview.info/maxrobust,259,260,-1
08:04:2014,maxrobustxtreme,http://goodpreview.info/maxrobustxtreme,522,522,0
08:04:2014,mightyraspberryketone,http://goodpreview.info/mightyraspberryketone,5107,5115,-8
08:04:2014,miraclegarciniacambogia,http://goodpreview.info/miraclegarciniacambogia,492,496,-4
08:04:2014,miraclegreencoffee,http://goodpreview.info/miraclegreencoffee,539,541,-2
08:04:2014,miraclesaffron,http://goodpreview.info/miraclesaffron,50,52,-2
08:04:2014,mitoslim,http://goodpreview.info/mitoslim,2059,2060,-1
08:04:2014,musclefactorx,http://goodpreview.info/musclefactorx,1441,1442,-1
08:04:2014,musclefactorx-1,http://goodpreview.info/musclefactorx-1,22,22,0
08:04:2014,musclekingpro,http://goodpreview.info/musclekingpro,501,501,0
08:04:2014,musclemaxextreme,http://goodpreview.info/musclemaxextreme,137,137,0
08:04:2014,muscleplus,http://goodpreview.info/muscleplus,143,143,0
08:04:2014,musclerevolutionpro,http://goodpreview.info/musclerevolutionpro,1420,1428,-8
08:04:2014,musclerevx,http://goodpreview.info/musclerevx,95,97,-2
08:04:2014,musclerevxtreme,http://goodpreview.info/musclerevxtreme,59,61,-2
08:04:2014,musclexlerator,http://goodpreview.info/musclexlerator,27,28,-1
08:04:2014,musclexmax,http://goodpreview.info/musclexmax,1437,1449,-12
08:04:2014,musclexmax1,http://goodpreview.info/musclexmax1,278,278,0
08:04:2014,musclezx90,http://goodpreview.info/musclezx90,4992,5000,-8
08:04:2014,naturalcleanse,http://goodpreview.info/naturalcleanse,8025,8034,-9
08:04:2014,naturalgarciniacambogia,http://goodpreview.info/naturalgarciniacambogia,2768,2769,-1
08:04:2014,naturalgreencoffee,http://goodpreview.info/naturalgreencoffee,8,9,-1
08:04:2014,naturalhealthgarcinia,http://goodpreview.info/naturalhealthgarcinia,53,53,0
08:04:2014,naturalpurecleanse,http://goodpreview.info/naturalpurecleanse,1568,10,1558
08:04:2014,nauseam,http://goodpreview.info/nauseam,135,135,0
08:04:2014,nauseamplus,http://goodpreview.info/nauseamplus,0,0,0
08:04:2014,nextrim,http://goodpreview.info/nextrim,1734,1738,-4
08:04:2014,nitricmusclemax,http://goodpreview.info/nitricmusclemax,14009,14232,-223
08:04:2014,nitrofocusno3,http://goodpreview.info/nitrofocusno3,91,94,-3
08:04:2014,niwali,http://goodpreview.info/niwali,823,825,-2
08:04:2014,no2explodeextreme,http://goodpreview.info/no2explodeextreme,163,163,0
08:04:2014,no2extremerush,http://goodpreview.info/no2extremerush,1306,1307,-1
08:04:2014,noflameecigs,http://goodpreview.info/noflameecigs,350,350,0
08:04:2014,nuclearno,http://goodpreview.info/nuclearno,367,368,-1
08:04:2014,nuetrim,http://goodpreview.info/nuetrim,660,660,0
08:04:2014,nutragreencoffee,http://goodpreview.info/nutragreencoffee,3570,5,3565
08:04:2014,nutrapuregarcinia,http://goodpreview.info/nutrapuregarcinia,211,211,0
08:04:2014,nutratoneplus,http://goodpreview.info/nutratoneplus,1004,1004,0
08:04:2014,nutriberryslim,http://goodpreview.info/nutriberryslim,1162,1199,-37
08:04:2014,nuvoryn,http://goodpreview.info/nuvoryn,22,22,0
08:04:2014,optimalstack,http://goodpreview.info/optimalstack,1657,1662,-5
08:04:2014,optimummuscle,http://goodpreview.info/optimummuscle,207,208,-1
08:04:2014,organicgreencoffee,http://goodpreview.info/organicgreencoffee,91,91,0
08:04:2014,organicwhitekidneybean,http://goodpreview.info/organicwhitekidneybean,91,91,0
08:04:2014,orviax,http://goodpreview.info/orviax,89,89,0
08:04:2014,oxitamin,http://goodpreview.info/oxitamin,148,149,-1
08:04:2014,phtytoceramides,http://goodpreview.info/phtytoceramides,817,819,-2
08:04:2014,powerigf,http://goodpreview.info/powerigf,1834,1860,-26
08:04:2014,powerpumpxl,http://goodpreview.info/powerpumpxl,369,370,-1
08:04:2014,powerup,http://goodpreview.info/powerup,119,119,0
08:04:2014,premiermangocleanse,http://goodpreview.info/premiermangocleanse,515,516,-1
08:04:2014,premiumcleanse,http://goodpreview.info/premiumcleanse,2771,2787,-16
08:04:2014,premiumgarciniacambogia,http://goodpreview.info/premiumgarciniacambogia,402,404,-2
08:04:2014,premiumgarciniaextract,http://goodpreview.info/premiumgarciniaextract,714,715,-1
08:04:2014,premiumgreencoffee,http://goodpreview.info/premiumgreencoffee,119,119,0
08:04:2014,premiumgreencoffee800,http://goodpreview.info/premiumgreencoffee800,108,108,0
08:04:2014,premiumraspberryketone,http://goodpreview.info/premiumraspberryketone,43,44,-1
08:04:2014,primalitegarciniaextract,http://goodpreview.info/primalitegarciniaextract,743,753,-10
08:04:2014,progain350,http://goodpreview.info/progain350,240,247,-7
08:04:2014,prograce,http://goodpreview.info/prograce,3,4,-1
08:04:2014,promusclecomplex,http://goodpreview.info/promusclecomplex,49,49,0
08:04:2014,propowercleanse,http://goodpreview.info/propowercleanse,1149,1196,-47
08:04:2014,pureberrymax,http://goodpreview.info/pureberrymax,215,215,0
08:04:2014,purecleansehealth,http://goodpreview.info/purecleansehealth,110,111,-1
08:04:2014,purecollagen,http://goodpreview.info/purecollagen,2225,2225,0
08:04:2014,puregarciniacambogia,http://goodpreview.info/puregarciniacambogia,1214,1215,-1
08:04:2014,puregarciniaslim,http://goodpreview.info/puregarciniaslim,168,171,-3
08:04:2014,puregreencoffeebeanextract,http://goodpreview.info/puregreencoffeebeanextract,2721,2725,-4
08:04:2014,puregreencoffeemaxima,http://goodpreview.info/puregreencoffeemaxima,37,37,0
08:04:2014,puregriffonia,http://goodpreview.info/puregriffonia,96,96,0
08:04:2014,pureketoneslim,http://goodpreview.info/pureketoneslim,32,33,-1
08:04:2014,purelifeclanse,http://goodpreview.info/purelifeclanse,11,14,-3
08:04:2014,puremusclepro,http://goodpreview.info/puremusclepro,1808,1810,-2
08:04:2014,purenaturalcleanser,http://goodpreview.info/purenaturalcleanser,478,480,-2
08:04:2014,purephytoceramides,http://goodpreview.info/purephytoceramides,75,76,-1
08:04:2014,pureraspberryketonepremium,http://goodpreview.info/pureraspberryketonepremium,63,64,-1
08:04:2014,puresaffronslim,http://goodpreview.info/puresaffronslim,423,424,-1
08:04:2014,pureslim57,http://goodpreview.info/pureslim57,126,128,-2
08:04:2014,purgarciniacambogia,http://goodpreview.info/purgarciniacambogia,157,157,0
08:04:2014,purgreencoffee,http://goodpreview.info/purgreencoffee,1626,1626,0
08:04:2014,purifyre,http://goodpreview.info/purifyre,244,244,0
08:04:2014,purifyregreencoffee,http://goodpreview.info/purifyregreencoffee,0,0,0
08:04:2014,raspberryhealth,http://goodpreview.info/raspberryhealth,66,66,0
08:04:2014,raspberryketoneblast,http://goodpreview.info/raspberryketoneblast,4309,4380,-71
08:04:2014,raspberryketoned,http://goodpreview.info/raspberryketoned,4,7,-3
08:04:2014,raspberryketoneoptimum,http://goodpreview.info/raspberryketoneoptimum,5,5,0
08:04:2014,raspberryketonepremium,http://goodpreview.info/raspberryketonepremium,79,79,0
08:04:2014,raspberryketonepure,http://goodpreview.info/raspberryketonepure,2,2,0
08:04:2014,raspberryketonethin,http://goodpreview.info/raspberryketonethin,41,55,-14
08:04:2014,raspberryslimplus,http://goodpreview.info/raspberryslimplus,127,130,-3
08:04:2014,refuelextreme,http://goodpreview.info/refuelextreme,494,504,-10
08:04:2014,regalecig,http://goodpreview.info/regalecig,375,377,-2
08:04:2014,regalecigs,http://goodpreview.info/regalecigs,41,43,-2
08:04:2014,rejuvaglow,http://goodpreview.info/rejuvaglow,71,71,0
08:04:2014,rejuveneyemax,http://goodpreview.info/rejuveneyemax,85,93,-8
08:04:2014,rellift,http://goodpreview.info/rellift,29,29,0
08:04:2014,renovo,http://goodpreview.info/renovo,38,40,-2
08:04:2014,restiflex,http://goodpreview.info/restiflex,64,64,0
08:04:2014,revitalize,http://goodpreview.info/revitalize,26,26,0
08:04:2014,revitatone,http://goodpreview.info/revitatone,8999,9030,-31
08:04:2014,revolutionaryraspberryketone,http://goodpreview.info/revolutionaryraspberryketone,65,65,0
08:04:2014,revoreplex,http://goodpreview.info/revoreplex,10,12,-2
08:04:2014,revtesttestosterone,http://goodpreview.info/revtesttestosterone,1593,1594,-1
08:04:2014,rippedmusclex,http://goodpreview.info/rippedmusclex,197,205,-8
08:04:2014,rippedxburn,http://goodpreview.info/rippedxburn,187,193,-6
08:04:2014,sacredarganoil,http://goodpreview.info/sacredarganoil,49,49,0
08:04:2014,safercolon,http://goodpreview.info/safercolon,3252,3309,-57
08:04:2014,saffronextractpremium,http://goodpreview.info/saffronextractpremium,105,106,-1
08:04:2014,saffronextractselect,http://goodpreview.info/saffronextractselect,1369,1374,-5
08:04:2014,saffronselect,http://goodpreview.info/saffronselect,74,75,-1
08:04:2014,secretgreencoffee,http://goodpreview.info/secretgreencoffee,263,267,-4
08:04:2014,simpleantiaging,http://goodpreview.info/simpleantiaging,231,231,0
08:04:2014,simplygarcinia,http://goodpreview.info/simplygarcinia,1136,1156,-20
08:04:2014,skinlift,http://goodpreview.info/skinlift,2149,2149,0
08:04:2014,slendera,http://goodpreview.info/slendera,15,15,0
08:04:2014,slenderagc-1,http://goodpreview.info/slenderagc-1,405,418,-13
08:04:2014,slimatrex,http://goodpreview.info/slimatrex,618,618,0
08:04:2014,slimhelper,http://goodpreview.info/slimhelper,247,247,0
08:04:2014,slimher,http://goodpreview.info/slimher,171,172,-1
08:04:2014,slimmeryougarcinia,http://goodpreview.info/slimmeryougarcinia,0,0,0
08:04:2014,slimtropical,http://goodpreview.info/slimtropical,808,811,-3
08:04:2014,slimtropicalmx,http://goodpreview.info/slimtropicalmx,135,135,0
08:04:2014,slimzenu,http://goodpreview.info/slimzenu,201,201,0
08:04:2014,smokestarecig,http://goodpreview.info/smokestarecig,556,559,-3
08:04:2014,solpriaxtreme,http://goodpreview.info/solpriaxtreme,2792,2794,-2
08:04:2014,sorepressin,http://goodpreview.info/sorepressin,6,6,0
08:04:2014,speedtrimxs,http://goodpreview.info/speedtrimxs,95,95,0
08:04:2014,splendyr,http://goodpreview.info/splendyr,1276,1276,0
08:04:2014,splendyrantiaging,http://goodpreview.info/splendyrantiaging,51,52,-1
08:04:2014,superacaicleanse,http://goodpreview.info/superacaicleanse,22,22,0
08:04:2014,supercleansetotal,http://goodpreview.info/supercleansetotal,75,79,-4
08:04:2014,supergreencoffee,http://goodpreview.info/supergreencoffee,11,11,0
08:04:2014,supergreencoffeebean,http://goodpreview.info/supergreencoffeebean,20,20,0
08:04:2014,superiormusclex,http://goodpreview.info/superiormusclex,17,26,-9
08:04:2014,superiorvelvet,http://goodpreview.info/superiorvelvet,1,1,0
08:04:2014,superyacon1000,http://goodpreview.info/superyacon1000,23,25,-2
08:04:2014,supracleanse350,http://goodpreview.info/supracleanse350,0,0,0
08:04:2014,supragreencoffee,http://goodpreview.info/supragreencoffee,929,934,-5
08:04:2014,supragreencoffeebean,http://goodpreview.info/supragreencoffeebean,0,0,0
08:04:2014,surelyyoung,http://goodpreview.info/surelyyoung,29,30,-1
08:04:2014,swissrose,http://goodpreview.info/swissrose,341,343,-2
08:04:2014,swolekreate,http://goodpreview.info/swolekreate,193,194,-1
08:04:2014,syneocell,http://goodpreview.info/syneocell,57,58,-1
08:04:2014,t-force,http://goodpreview.info/t-force,199,204,-5
08:04:2014,testforcextreme,http://goodpreview.info/testforcextreme,491,492,-1
08:04:2014,testoforce,http://goodpreview.info/testoforce,21,22,-1
08:04:2014,testorushrx,http://goodpreview.info/testorushrx,41,41,0
08:04:2014,testosteronemax,http://goodpreview.info/testosteronemax,330,331,-1
08:04:2014,testoxl,http://goodpreview.info/testoxl,1481,1483,-2
08:04:2014,thinmagic,http://goodpreview.info/thinmagic,275,275,0
08:04:2014,thinmagicmax,http://goodpreview.info/thinmagicmax,0,0,0
08:04:2014,thinsport,http://goodpreview.info/thinsport,212,212,0
08:04:2014,titaniumprox,http://goodpreview.info/titaniumprox,0,0,0
08:04:2014,totalbodyfresh,http://goodpreview.info/totalbodyfresh,125,127,-2
08:04:2014,trigx2,http://goodpreview.info/trigx2,14,15,-1
08:04:2014,trimaleana,http://goodpreview.info/trimaleana,142,142,0
08:04:2014,trimatol,http://goodpreview.info/trimatol,123,124,-1
08:04:2014,trimblendgarciniacambogia,http://goodpreview.info/trimblendgarciniacambogia,76,76,0
08:04:2014,triminexgarciniacambogia,http://goodpreview.info/triminexgarciniacambogia,91,92,-1
08:04:2014,triminexgreencoffee,http://goodpreview.info/triminexgreencoffee,57,58,-1
08:04:2014,tripleeffectseyeserum,http://goodpreview.info/tripleeffectseyeserum,618,619,-1
08:04:2014,turboextracut,http://goodpreview.info/turboextracut,162,162,0
08:04:2014,turboshred,http://goodpreview.info/turboshred,100,100,0
08:04:2014,ultimategarcinia,http://goodpreview.info/ultimategarcinia,165,165,0
08:04:2014,ultramaxtestosterone,http://goodpreview.info/ultramaxtestosterone,33,33,0
08:04:2014,ultrapurecoloncleanse,http://goodpreview.info/ultrapurecoloncleanse,5,5,0
08:04:2014,ultraraspberryketone,http://goodpreview.info/ultraraspberryketone,418,419,-1
08:04:2014,velora,http://goodpreview.info/velora,23,23,0
08:04:2014,velveskin,http://goodpreview.info/velveskin,18,19,-1
08:04:2014,vencleanse,http://goodpreview.info/vencleanse,431,432,-1
08:04:2014,viarex,http://goodpreview.info/viarex,608,610,-2
08:04:2014,vitalifedetox,http://goodpreview.info/vitalifedetox,257,257,0
08:04:2014,vitalitygreencoffee,http://goodpreview.info/vitalitygreencoffee,85,85,0
08:04:2014,vitamax,http://goodpreview.info/vitamax,22,22,0
08:04:2014,vitolipo,http://goodpreview.info/vitolipo,1149,1150,-1
08:04:2014,vydox,http://goodpreview.info/vydox,315,323,-8
08:04:2014,wildraspberryketone,http://goodpreview.info/wildraspberryketone,188,198,-10
08:04:2014,wrinklesscream,http://goodpreview.info/wrinklesscream,293,300,-7
08:04:2014,xenaslim,http://goodpreview.info/xenaslim,42,42,0
08:04:2014,xengthx1,http://goodpreview.info/xengthx1,34,34,0
08:04:2014,xlerator,http://goodpreview.info/xlerator,0,0,0
08:04:2014,xocigs,http://goodpreview.info/xocigs,65,65,0
08:04:2014,xtgenix,http://goodpreview.info/xtgenix,12967,12979,-12
08:04:2014,xtrememusclepro,http://goodpreview.info/xtrememusclepro,613,614,-1
08:04:2014,yaconsplash,http://goodpreview.info/yaconsplash,22,23,-1
08:04:2014,yaconsyruporiginal,http://goodpreview.info/yaconsyruporiginal,95,95,0
08:04:2014,yaconsyrupsecret,http://goodpreview.info/yaconsyrupsecret,34,35,-1
08:04:2014,yoloboost,http://goodpreview.info/yoloboost,8,15,-7
08:04:2014,youthkiteyecream,http://goodpreview.info/youthkiteyecream,245,246,-1
