dt_today,sitetitle,sitelink,pre_click,new_clicks,difrnce
04:04:2014,11fruits,http://goodpreview.info/11fruits,199,200,-1
04:04:2014,1285muscle,http://goodpreview.info/1285muscle,2856,2861,-5
04:04:2014,92trimgreencoffee,http://goodpreview.info/92trimgreencoffee,35,35,0
04:04:2014,Americig,http://goodpreview.info/Americig,412,426,-14
04:04:2014,Nuvagenic,http://goodpreview.info/Nuvagenic,1099,1101,-2
04:04:2014,Prolexin,http://goodpreview.info/Prolexin,743,777,-34
04:04:2014,SVELME,http://goodpreview.info/SVELME,789,790,-1
04:04:2014,SlimSpray,http://goodpreview.info/SlimSpray,268,269,-1
04:04:2014,acaiberryfresh,http://goodpreview.info/acaiberryfresh,96,98,-2
04:04:2014,acainatural,http://goodpreview.info/acainatural,132,132,0
04:04:2014,acaiultralean,http://goodpreview.info/acaiultralean,129,129,0
04:04:2014,advancedgarciniacambogia,http://goodpreview.info/advancedgarciniacambogia,882,884,-2
04:04:2014,advancedgarciniacambogia-fr,http://goodpreview.info/advancedgarciniacambogia-fr,114,119,-5
04:04:2014,advancedgarciniacambogia1,http://goodpreview.info/advancedgarciniacambogia1,23,26,-3
04:04:2014,advancedkrealkalyn,http://goodpreview.info/advancedkrealkalyn,146,146,0
04:04:2014,advancedpurecleanse,http://goodpreview.info/advancedpurecleanse,0,0,0
04:04:2014,advancedpurecleanse1,http://goodpreview.info/advancedpurecleanse1,23,27,-4
04:04:2014,africanmangoboost,http://goodpreview.info/africanmangoboost,118,118,0
04:04:2014,africanmangoprox,http://goodpreview.info/africanmangoprox,42,42,0
04:04:2014,africanmangopure,http://goodpreview.info/africanmangopure,76,76,0
04:04:2014,aktiveam,http://goodpreview.info/aktiveam,1603,1604,-1
04:04:2014,aktivepm,http://goodpreview.info/aktivepm,1994,2002,-8
04:04:2014,alphajacked,http://goodpreview.info/alphajacked,772,772,0
04:04:2014,alphamaxplus,http://goodpreview.info/alphamaxplus,13,14,-1
04:04:2014,amazing,http://goodpreview.info/amazing,317,330,-13
04:04:2014,aminomuscle,http://goodpreview.info/aminomuscle,1193,1195,-2
04:04:2014,aminoprime,http://goodpreview.info/aminoprime,110,110,0
04:04:2014,aminoprimexl,http://goodpreview.info/aminoprimexl,284,284,0
04:04:2014,anabolicrx24,http://goodpreview.info/anabolicrx24,17386,17659,-273
04:04:2014,anatomyx5,http://goodpreview.info/anatomyx5,3,3,0
04:04:2014,androsolve,http://goodpreview.info/androsolve,1473,1473,0
04:04:2014,androx,http://goodpreview.info/androx,13200,13465,-265
04:04:2014,anoradrol,http://goodpreview.info/anoradrol,214,215,-1
04:04:2014,auravie,http://goodpreview.info/auravie,104,104,0
04:04:2014,authenticgreencoffee,http://goodpreview.info/authenticgreencoffee,240,240,0
04:04:2014,beaudify,http://goodpreview.info/beaudify,73,73,0
04:04:2014,beautefxbbcream,http://goodpreview.info/beautefxbbcream,2,2,0
04:04:2014,beautynectarcollagen,http://goodpreview.info/beautynectarcollagen,132,132,0
04:04:2014,beddefense,http://goodpreview.info/beddefense,27,27,0
04:04:2014,bellagenix,http://goodpreview.info/bellagenix,138,138,0
04:04:2014,bellalabs,http://goodpreview.info/bellalabs,8,8,0
04:04:2014,bellaplex,http://goodpreview.info/bellaplex,112,0,112
04:04:2014,beriultimatepro,http://goodpreview.info/beriultimatepro,68,68,0
04:04:2014,berrythin,http://goodpreview.info/berrythin,325,325,0
04:04:2014,betaalaninemax,http://goodpreview.info/betaalaninemax,0,0,0
04:04:2014,betaalaninextreme,http://goodpreview.info/betaalaninextreme,16,16,0
04:04:2014,beyondraspberry,http://goodpreview.info/beyondraspberry,75,75,0
04:04:2014,biohealthgarciniacambogia,http://goodpreview.info/biohealthgarciniacambogia,3426,3502,-76
04:04:2014,biomelt,http://goodpreview.info/biomelt,330,340,-10
04:04:2014,blastxl,http://goodpreview.info/blastxl,156,156,0
04:04:2014,bodycleanseplus,http://goodpreview.info/bodycleanseplus,66,66,0
04:04:2014,bodywrap,http://goodpreview.info/bodywrap,206,207,-1
04:04:2014,breakfree,http://goodpreview.info/breakfree,111,111,0
04:04:2014,cambogiatrim,http://goodpreview.info/cambogiatrim,598,598,0
04:04:2014,capsicum,http://goodpreview.info/capsicum,139,139,0
04:04:2014,celebritycleanser,http://goodpreview.info/celebritycleanser,83,94,-11
04:04:2014,celebrityraspberry,http://goodpreview.info/celebrityraspberry,136,137,-1
04:04:2014,cellanafricanmango,http://goodpreview.info/cellanafricanmango,248,250,-2
04:04:2014,cellogicaskin,http://goodpreview.info/cellogicaskin,47,50,-3
04:04:2014,centrislim,http://goodpreview.info/centrislim,199,199,0
04:04:2014,certifiedgreencoffee,http://goodpreview.info/certifiedgreencoffee,149,149,0
04:04:2014,certifiedpuregreencoffee,http://goodpreview.info/certifiedpuregreencoffee,19,19,0
04:04:2014,chiocegreencoffee,http://goodpreview.info/chiocegreencoffee,545,545,0
04:04:2014,choicegreencoffee,http://goodpreview.info/choicegreencoffee,345,352,-7
04:04:2014,cleansefx,http://goodpreview.info/cleansefx,143,199,-56
04:04:2014,cleanseplus,http://goodpreview.info/cleanseplus,378,384,-6
04:04:2014,cleanseplus1,http://goodpreview.info/cleanseplus1,0,0,0
04:04:2014,cleansepremium,http://goodpreview.info/cleansepremium,15,15,0
04:04:2014,cleansewonder,http://goodpreview.info/cleansewonder,195,200,-5
04:04:2014,cleansextrem,http://goodpreview.info/cleansextrem,77,122,-45
04:04:2014,cleantrim,http://goodpreview.info/cleantrim,226,226,0
04:04:2014,clearcleansepro,http://goodpreview.info/clearcleansepro,108,108,0
04:04:2014,clearsmoke,http://goodpreview.info/clearsmoke,174,176,-2
04:04:2014,codered7,http://goodpreview.info/codered7,300,301,-1
04:04:2014,coleanse,http://goodpreview.info/coleanse,123,124,-1
04:04:2014,collaton,http://goodpreview.info/collaton,88,88,0
04:04:2014,colocleansepro,http://goodpreview.info/colocleansepro,0,0,0
04:04:2014,coloncleansetotal,http://goodpreview.info/coloncleansetotal,14,16,-2
04:04:2014,colonpurecleanse,http://goodpreview.info/colonpurecleanse,131,131,0
04:04:2014,colothin,http://goodpreview.info/colothin,988,988,0
04:04:2014,completecoffeecleanse,http://goodpreview.info/completecoffeecleanse,1976,1981,-5
04:04:2014,complexiderm,http://goodpreview.info/complexiderm,103,103,0
04:04:2014,corecutter,http://goodpreview.info/corecutter,35,35,0
04:04:2014,csorex,http://goodpreview.info/csorex,174,174,0
04:04:2014,dailyfacelift,http://goodpreview.info/dailyfacelift,92,92,0
04:04:2014,dailyfacestemcelltechnology,http://goodpreview.info/dailyfacestemcelltechnology,193,193,0
04:04:2014,dailypowercleanse,http://goodpreview.info/dailypowercleanse,112,114,-2
04:04:2014,deerantlerxtreme,http://goodpreview.info/deerantlerxtreme,131,131,0
04:04:2014,dermarose,http://goodpreview.info/dermarose,112,112,0
04:04:2014,dermaset,http://goodpreview.info/dermaset,51,51,0
04:04:2014,dermpure,http://goodpreview.info/dermpure,80,80,0
04:04:2014,dietgreencoffeebean,http://goodpreview.info/dietgreencoffeebean,310,310,0
04:04:2014,drillpill,http://goodpreview.info/drillpill,454,455,-1
04:04:2014,elevategf,http://goodpreview.info/elevategf,174,174,0
04:04:2014,elier,http://goodpreview.info/elier,50,50,0
04:04:2014,elierskincare,http://goodpreview.info/elierskincare,40,40,0
04:04:2014,elitetest360,http://goodpreview.info/elitetest360,408,419,-11
04:04:2014,emeraldluxecig,http://goodpreview.info/emeraldluxecig,112,112,0
04:04:2014,enduros,http://goodpreview.info/enduros,953,957,-4
04:04:2014,envigra,http://goodpreview.info/envigra,105,105,0
04:04:2014,estrodetox,http://goodpreview.info/estrodetox,97,98,-1
04:04:2014,extentxl,http://goodpreview.info/extentxl,173,175,-2
04:04:2014,fembalance,http://goodpreview.info/fembalance,17,17,0
04:04:2014,flawlessraspberryketone,http://goodpreview.info/flawlessraspberryketone,79,80,-1
04:04:2014,formulat10,http://goodpreview.info/formulat10,1503,1505,-2
04:04:2014,garcinaiawow1,http://goodpreview.info/garcinaiawow1,36,43,-7
04:04:2014,garciniacambogia,http://goodpreview.info/garciniacambogia,142,182,-40
04:04:2014,garciniacambogia1000,http://goodpreview.info/garciniacambogia1000,61,62,-1
04:04:2014,garciniacambogiaelite,http://goodpreview.info/garciniacambogiaelite,5215,5228,-13
04:04:2014,garciniacambogiafatbuster,http://goodpreview.info/garciniacambogiafatbuster,90,90,0
04:04:2014,garciniacambogiamax,http://goodpreview.info/garciniacambogiamax,2402,2405,-3
04:04:2014,garciniacambogiamiracle,http://goodpreview.info/garciniacambogiamiracle,128,128,0
04:04:2014,garciniacambogiapremium,http://goodpreview.info/garciniacambogiapremium,1075,1075,0
04:04:2014,garciniacambogiapureextract,http://goodpreview.info/garciniacambogiapureextract,141,141,0
04:04:2014,garciniacambogiapureselect,http://goodpreview.info/garciniacambogiapureselect,587,594,-7
04:04:2014,garciniacambogiasupreme,http://goodpreview.info/garciniacambogiasupreme,2975,3050,-75
04:04:2014,garciniacambogiatoday,http://goodpreview.info/garciniacambogiatoday,125,126,-1
04:04:2014,garciniacambogiaultra,http://goodpreview.info/garciniacambogiaultra,356,358,-2
04:04:2014,garciniaforte,http://goodpreview.info/garciniaforte,2675,11,2664
04:04:2014,garciniafreetrial,http://goodpreview.info/garciniafreetrial,67,67,0
04:04:2014,garciniagreen,http://goodpreview.info/garciniagreen,831,834,-3
04:04:2014,garciniapureelite1,http://goodpreview.info/garciniapureelite1,1,1,0
04:04:2014,garciniatoday,http://goodpreview.info/garciniatoday,0,0,0
04:04:2014,garciniatotal,http://goodpreview.info/garciniatotal,87,89,-2
04:04:2014,garciniawow,http://goodpreview.info/garciniawow,809,870,-61
04:04:2014,garcinium,http://goodpreview.info/garcinium,19,33,-14
04:04:2014,gc7x,http://goodpreview.info/gc7x,102,102,0
04:04:2014,gc7xgreencoffee,http://goodpreview.info/gc7xgreencoffee,0,0,0
04:04:2014,gcbultra,http://goodpreview.info/gcbultra,51,52,-1
04:04:2014,gcbx,http://goodpreview.info/gcbx,17070,17077,-7
04:04:2014,gcbx1,http://goodpreview.info/gcbx1,196,196,0
04:04:2014,gcspeedslim,http://goodpreview.info/gcspeedslim,5679,5715,-36
04:04:2014,gcultra,http://goodpreview.info/gcultra,135,135,0
04:04:2014,gcultragarcinia,http://goodpreview.info/gcultragarcinia,4,4,0
04:04:2014,geneme,http://goodpreview.info/geneme,39,39,0
04:04:2014,getnaturalgarcinia,http://goodpreview.info/getnaturalgarcinia,40,40,0
04:04:2014,greencoffeeadvanced,http://goodpreview.info/greencoffeeadvanced,181,181,0
04:04:2014,greencoffeebean8000,http://goodpreview.info/greencoffeebean8000,66,66,0
04:04:2014,greencoffeebody,http://goodpreview.info/greencoffeebody,33,33,0
04:04:2014,greencoffeeburn,http://goodpreview.info/greencoffeeburn,22,24,-2
04:04:2014,greencoffeeextreme,http://goodpreview.info/greencoffeeextreme,84,84,0
04:04:2014,greencoffeemax,http://goodpreview.info/greencoffeemax,127,130,-3
04:04:2014,greencoffeemaxx,http://goodpreview.info/greencoffeemaxx,3,3,0
04:04:2014,greencoffeeoptimum,http://goodpreview.info/greencoffeeoptimum,122,122,0
04:04:2014,greencoffeeprogram,http://goodpreview.info/greencoffeeprogram,0,0,0
04:04:2014,greencoffeeultraslim,http://goodpreview.info/greencoffeeultraslim,205,206,-1
04:04:2014,greentonepro,http://goodpreview.info/greentonepro,308,308,0
04:04:2014,healthetrimgarcinia,http://goodpreview.info/healthetrimgarcinia,151,151,0
04:04:2014,healthychoicegc,http://goodpreview.info/healthychoicegc,741,741,0
04:04:2014,horsepowerplusxxxl,http://goodpreview.info/horsepowerplusxxxl,179,192,-13
04:04:2014,hugegenic,http://goodpreview.info/hugegenic,284,292,-8
04:04:2014,hydrellatone,http://goodpreview.info/hydrellatone,102,102,0
04:04:2014,hydrocollagen,http://goodpreview.info/hydrocollagen,42,43,-1
04:04:2014,hydroderm,http://goodpreview.info/hydroderm,43,43,0
04:04:2014,hyperfuel9x,http://goodpreview.info/hyperfuel9x,1903,1909,-6
04:04:2014,illuminatedteeth,http://goodpreview.info/illuminatedteeth,40,40,0
04:04:2014,instantwrinklerepair,http://goodpreview.info/instantwrinklerepair,18,18,0
04:04:2014,iqderma,http://goodpreview.info/iqderma,413,413,0
04:04:2014,iqdermaessen,http://goodpreview.info/iqdermaessen,0,0,0
04:04:2014,ketoneoptimum,http://goodpreview.info/ketoneoptimum,151,151,0
04:04:2014,kleanslim,http://goodpreview.info/kleanslim,99,99,0
04:04:2014,lacreme,http://goodpreview.info/lacreme,751,781,-30
04:04:2014,leanmuscleformula,http://goodpreview.info/leanmuscleformula,20,25,-5
04:04:2014,ledermeluxe,http://goodpreview.info/ledermeluxe,185,185,0
04:04:2014,leparfait,http://goodpreview.info/leparfait,15,16,-1
04:04:2014,leparisehydragold,http://goodpreview.info/leparisehydragold,0,1,-1
04:04:2014,levela,http://goodpreview.info/levela,105,105,0
04:04:2014,lifedetox,http://goodpreview.info/lifedetox,145,145,0
04:04:2014,liftserumpro,http://goodpreview.info/liftserumpro,182,186,-4
04:04:2014,liposlender,http://goodpreview.info/liposlender,23,24,-1
04:04:2014,liposlim,http://goodpreview.info/liposlim,1854,1865,-11
04:04:2014,liposom,http://goodpreview.info/liposom,60,61,-1
04:04:2014,liveskinny,http://goodpreview.info/liveskinny,232,232,0
04:04:2014,lumahydrate,http://goodpreview.info/lumahydrate,361,379,-18
04:04:2014,lumarepair,http://goodpreview.info/lumarepair,451,457,-6
04:04:2014,lunathin,http://goodpreview.info/lunathin,122,122,0
04:04:2014,luxoderm,http://goodpreview.info/luxoderm,196,198,-2
04:04:2014,lysocleanse,http://goodpreview.info/lysocleanse,1739,1750,-11
04:04:2014,maxdetoxpro,http://goodpreview.info/maxdetoxpro,574,574,0
04:04:2014,maxgarciniaburn,http://goodpreview.info/maxgarciniaburn,455,455,0
04:04:2014,maximumshred,http://goodpreview.info/maximumshred,1513,1517,-4
04:04:2014,maxrobust,http://goodpreview.info/maxrobust,250,251,-1
04:04:2014,maxrobustxtreme,http://goodpreview.info/maxrobustxtreme,520,521,-1
04:04:2014,mightyraspberryketone,http://goodpreview.info/mightyraspberryketone,5097,5100,-3
04:04:2014,miraclegarciniacambogia,http://goodpreview.info/miraclegarciniacambogia,473,478,-5
04:04:2014,miraclegreencoffee,http://goodpreview.info/miraclegreencoffee,462,500,-38
04:04:2014,miraclesaffron,http://goodpreview.info/miraclesaffron,46,47,-1
04:04:2014,mitoslim,http://goodpreview.info/mitoslim,2050,2053,-3
04:04:2014,musclefactorx,http://goodpreview.info/musclefactorx,1428,1430,-2
04:04:2014,musclefactorx-1,http://goodpreview.info/musclefactorx-1,20,20,0
04:04:2014,musclekingpro,http://goodpreview.info/musclekingpro,499,499,0
04:04:2014,musclemaxextreme,http://goodpreview.info/musclemaxextreme,137,137,0
04:04:2014,muscleplus,http://goodpreview.info/muscleplus,139,140,-1
04:04:2014,musclerevolutionpro,http://goodpreview.info/musclerevolutionpro,1393,1398,-5
04:04:2014,musclerevx,http://goodpreview.info/musclerevx,79,82,-3
04:04:2014,musclerevxtreme,http://goodpreview.info/musclerevxtreme,57,57,0
04:04:2014,musclexlerator,http://goodpreview.info/musclexlerator,19,24,-5
04:04:2014,musclexmax,http://goodpreview.info/musclexmax,1394,1423,-29
04:04:2014,musclexmax1,http://goodpreview.info/musclexmax1,275,277,-2
04:04:2014,musclezx90,http://goodpreview.info/musclezx90,4935,4955,-20
04:04:2014,naturalcleanse,http://goodpreview.info/naturalcleanse,7978,7987,-9
04:04:2014,naturalgarciniacambogia,http://goodpreview.info/naturalgarciniacambogia,2751,2753,-2
04:04:2014,naturalgreencoffee,http://goodpreview.info/naturalgreencoffee,7,7,0
04:04:2014,naturalhealthgarcinia,http://goodpreview.info/naturalhealthgarcinia,47,48,-1
04:04:2014,naturalpurecleanse,http://goodpreview.info/naturalpurecleanse,1528,1536,-8
04:04:2014,nauseam,http://goodpreview.info/nauseam,133,133,0
04:04:2014,nauseamplus,http://goodpreview.info/nauseamplus,0,0,0
04:04:2014,nextrim,http://goodpreview.info/nextrim,1720,1722,-2
04:04:2014,nitricmusclemax,http://goodpreview.info/nitricmusclemax,13213,13425,-212
04:04:2014,nitrofocusno3,http://goodpreview.info/nitrofocusno3,64,71,-7
04:04:2014,niwali,http://goodpreview.info/niwali,802,805,-3
04:04:2014,no2explodeextreme,http://goodpreview.info/no2explodeextreme,159,161,-2
04:04:2014,no2extremerush,http://goodpreview.info/no2extremerush,1296,1297,-1
04:04:2014,noflameecigs,http://goodpreview.info/noflameecigs,350,350,0
04:04:2014,nuclearno,http://goodpreview.info/nuclearno,365,367,-2
04:04:2014,nuetrim,http://goodpreview.info/nuetrim,658,659,-1
04:04:2014,nutragreencoffee,http://goodpreview.info/nutragreencoffee,3529,3541,-12
04:04:2014,nutrapuregarcinia,http://goodpreview.info/nutrapuregarcinia,206,208,-2
04:04:2014,nutratoneplus,http://goodpreview.info/nutratoneplus,993,999,-6
04:04:2014,nutriberryslim,http://goodpreview.info/nutriberryslim,1063,1097,-34
04:04:2014,nuvoryn,http://goodpreview.info/nuvoryn,22,22,0
04:04:2014,optimalstack,http://goodpreview.info/optimalstack,1639,1645,-6
04:04:2014,optimummuscle,http://goodpreview.info/optimummuscle,202,203,-1
04:04:2014,organicgreencoffee,http://goodpreview.info/organicgreencoffee,90,90,0
04:04:2014,organicwhitekidneybean,http://goodpreview.info/organicwhitekidneybean,90,90,0
04:04:2014,orviax,http://goodpreview.info/orviax,88,88,0
04:04:2014,oxitamin,http://goodpreview.info/oxitamin,146,146,0
04:04:2014,phtytoceramides,http://goodpreview.info/phtytoceramides,791,799,-8
04:04:2014,powerigf,http://goodpreview.info/powerigf,1749,1780,-31
04:04:2014,powerpumpxl,http://goodpreview.info/powerpumpxl,366,367,-1
04:04:2014,powerup,http://goodpreview.info/powerup,115,117,-2
04:04:2014,premiermangocleanse,http://goodpreview.info/premiermangocleanse,511,512,-1
04:04:2014,premiumcleanse,http://goodpreview.info/premiumcleanse,2729,2737,-8
04:04:2014,premiumgarciniacambogia,http://goodpreview.info/premiumgarciniacambogia,398,400,-2
04:04:2014,premiumgarciniaextract,http://goodpreview.info/premiumgarciniaextract,701,704,-3
04:04:2014,premiumgreencoffee,http://goodpreview.info/premiumgreencoffee,119,119,0
04:04:2014,premiumgreencoffee800,http://goodpreview.info/premiumgreencoffee800,108,108,0
04:04:2014,premiumraspberryketone,http://goodpreview.info/premiumraspberryketone,43,43,0
04:04:2014,primalitegarciniaextract,http://goodpreview.info/primalitegarciniaextract,704,715,-11
04:04:2014,progain350,http://goodpreview.info/progain350,207,216,-9
04:04:2014,prograce,http://goodpreview.info/prograce,3,3,0
04:04:2014,promusclecomplex,http://goodpreview.info/promusclecomplex,49,49,0
04:04:2014,propowercleanse,http://goodpreview.info/propowercleanse,973,1019,-46
04:04:2014,pureberrymax,http://goodpreview.info/pureberrymax,214,214,0
04:04:2014,purecleansehealth,http://goodpreview.info/purecleansehealth,107,107,0
04:04:2014,purecollagen,http://goodpreview.info/purecollagen,2220,2221,-1
04:04:2014,puregarciniacambogia,http://goodpreview.info/puregarciniacambogia,1205,1208,-3
04:04:2014,puregarciniaslim,http://goodpreview.info/puregarciniaslim,145,155,-10
04:04:2014,puregreencoffeebeanextract,http://goodpreview.info/puregreencoffeebeanextract,2701,2707,-6
04:04:2014,puregreencoffeemaxima,http://goodpreview.info/puregreencoffeemaxima,37,37,0
04:04:2014,puregriffonia,http://goodpreview.info/puregriffonia,96,96,0
04:04:2014,pureketoneslim,http://goodpreview.info/pureketoneslim,30,31,-1
04:04:2014,purelifeclanse,http://goodpreview.info/purelifeclanse,6,6,0
04:04:2014,puremusclepro,http://goodpreview.info/puremusclepro,1800,1801,-1
04:04:2014,purenaturalcleanser,http://goodpreview.info/purenaturalcleanser,477,477,0
04:04:2014,purephytoceramides,http://goodpreview.info/purephytoceramides,73,74,-1
04:04:2014,pureraspberryketonepremium,http://goodpreview.info/pureraspberryketonepremium,62,62,0
04:04:2014,puresaffronslim,http://goodpreview.info/puresaffronslim,423,423,0
04:04:2014,pureslim57,http://goodpreview.info/pureslim57,126,126,0
04:04:2014,purgarciniacambogia,http://goodpreview.info/purgarciniacambogia,157,157,0
04:04:2014,purgreencoffee,http://goodpreview.info/purgreencoffee,1626,1626,0
04:04:2014,purifyre,http://goodpreview.info/purifyre,244,244,0
04:04:2014,purifyregreencoffee,http://goodpreview.info/purifyregreencoffee,0,0,0
04:04:2014,raspberryhealth,http://goodpreview.info/raspberryhealth,56,60,-4
04:04:2014,raspberryketoneblast,http://goodpreview.info/raspberryketoneblast,4087,4147,-60
04:04:2014,raspberryketoned,http://goodpreview.info/raspberryketoned,2,2,0
04:04:2014,raspberryketoneoptimum,http://goodpreview.info/raspberryketoneoptimum,5,5,0
04:04:2014,raspberryketonepremium,http://goodpreview.info/raspberryketonepremium,77,78,-1
04:04:2014,raspberryketonepure,http://goodpreview.info/raspberryketonepure,2,2,0
04:04:2014,raspberryketonethin,http://goodpreview.info/raspberryketonethin,435,9,426
04:04:2014,raspberryslimplus,http://goodpreview.info/raspberryslimplus,125,125,0
04:04:2014,refuelextreme,http://goodpreview.info/refuelextreme,470,480,-10
04:04:2014,regalecig,http://goodpreview.info/regalecig,364,369,-5
04:04:2014,regalecigs,http://goodpreview.info/regalecigs,40,40,0
04:04:2014,rejuvaglow,http://goodpreview.info/rejuvaglow,70,71,-1
04:04:2014,rejuveneyemax,http://goodpreview.info/rejuveneyemax,33,41,-8
04:04:2014,rellift,http://goodpreview.info/rellift,29,29,0
04:04:2014,renovo,http://goodpreview.info/renovo,37,37,0
04:04:2014,restiflex,http://goodpreview.info/restiflex,62,62,0
04:04:2014,revitalize,http://goodpreview.info/revitalize,25,25,0
04:04:2014,revitatone,http://goodpreview.info/revitatone,8827,8865,-38
04:04:2014,revolutionaryraspberryketone,http://goodpreview.info/revolutionaryraspberryketone,65,65,0
04:04:2014,revoreplex,http://goodpreview.info/revoreplex,2,6,-4
04:04:2014,revtesttestosterone,http://goodpreview.info/revtesttestosterone,1591,1591,0
04:04:2014,rippedmusclex,http://goodpreview.info/rippedmusclex,168,171,-3
04:04:2014,rippedxburn,http://goodpreview.info/rippedxburn,183,185,-2
04:04:2014,sacredarganoil,http://goodpreview.info/sacredarganoil,45,48,-3
04:04:2014,safercolon,http://goodpreview.info/safercolon,3000,3049,-49
04:04:2014,saffronextractpremium,http://goodpreview.info/saffronextractpremium,105,105,0
04:04:2014,saffronextractselect,http://goodpreview.info/saffronextractselect,1350,1359,-9
04:04:2014,saffronselect,http://goodpreview.info/saffronselect,72,72,0
04:04:2014,secretgreencoffee,http://goodpreview.info/secretgreencoffee,256,259,-3
04:04:2014,simpleantiaging,http://goodpreview.info/simpleantiaging,228,230,-2
04:04:2014,simplygarcinia,http://goodpreview.info/simplygarcinia,1070,1085,-15
04:04:2014,skinlift,http://goodpreview.info/skinlift,2145,2146,-1
04:04:2014,slendera,http://goodpreview.info/slendera,15,15,0
04:04:2014,slenderagc-1,http://goodpreview.info/slenderagc-1,392,396,-4
04:04:2014,slimatrex,http://goodpreview.info/slimatrex,613,616,-3
04:04:2014,slimhelper,http://goodpreview.info/slimhelper,245,245,0
04:04:2014,slimher,http://goodpreview.info/slimher,171,171,0
04:04:2014,slimmeryougarcinia,http://goodpreview.info/slimmeryougarcinia,0,0,0
04:04:2014,slimtropical,http://goodpreview.info/slimtropical,805,806,-1
04:04:2014,slimtropicalmx,http://goodpreview.info/slimtropicalmx,134,134,0
04:04:2014,slimzenu,http://goodpreview.info/slimzenu,200,201,-1
04:04:2014,smokestarecig,http://goodpreview.info/smokestarecig,543,548,-5
04:04:2014,solpriaxtreme,http://goodpreview.info/solpriaxtreme,2774,2780,-6
04:04:2014,sorepressin,http://goodpreview.info/sorepressin,6,6,0
04:04:2014,speedtrimxs,http://goodpreview.info/speedtrimxs,95,95,0
04:04:2014,splendyr,http://goodpreview.info/splendyr,1273,1273,0
04:04:2014,splendyrantiaging,http://goodpreview.info/splendyrantiaging,51,51,0
04:04:2014,superacaicleanse,http://goodpreview.info/superacaicleanse,20,21,-1
04:04:2014,supercleansetotal,http://goodpreview.info/supercleansetotal,63,67,-4
04:04:2014,supergreencoffee,http://goodpreview.info/supergreencoffee,11,11,0
04:04:2014,supergreencoffeebean,http://goodpreview.info/supergreencoffeebean,20,20,0
04:04:2014,superiormusclex,http://goodpreview.info/superiormusclex,92,94,-2
04:04:2014,superiorvelvet,http://goodpreview.info/superiorvelvet,1,1,0
04:04:2014,superyacon1000,http://goodpreview.info/superyacon1000,20,20,0
04:04:2014,supracleanse350,http://goodpreview.info/supracleanse350,0,0,0
04:04:2014,supragreencoffee,http://goodpreview.info/supragreencoffee,900,910,-10
04:04:2014,supragreencoffeebean,http://goodpreview.info/supragreencoffeebean,0,0,0
04:04:2014,surelyyoung,http://goodpreview.info/surelyyoung,29,29,0
04:04:2014,swissrose,http://goodpreview.info/swissrose,340,340,0
04:04:2014,swolekreate,http://goodpreview.info/swolekreate,192,192,0
04:04:2014,syneocell,http://goodpreview.info/syneocell,54,55,-1
04:04:2014,t-force,http://goodpreview.info/t-force,186,190,-4
04:04:2014,testforcextreme,http://goodpreview.info/testforcextreme,488,491,-3
04:04:2014,testoforce,http://goodpreview.info/testoforce,14,14,0
04:04:2014,testorushrx,http://goodpreview.info/testorushrx,38,40,-2
04:04:2014,testosteronemax,http://goodpreview.info/testosteronemax,328,328,0
04:04:2014,testoxl,http://goodpreview.info/testoxl,1465,1470,-5
04:04:2014,thinmagic,http://goodpreview.info/thinmagic,269,272,-3
04:04:2014,thinmagicmax,http://goodpreview.info/thinmagicmax,0,0,0
04:04:2014,thinsport,http://goodpreview.info/thinsport,211,211,0
04:04:2014,titaniumprox,http://goodpreview.info/titaniumprox,0,0,0
04:04:2014,totalbodyfresh,http://goodpreview.info/totalbodyfresh,112,114,-2
04:04:2014,trigx2,http://goodpreview.info/trigx2,9,9,0
04:04:2014,trimaleana,http://goodpreview.info/trimaleana,142,142,0
04:04:2014,trimatol,http://goodpreview.info/trimatol,121,121,0
04:04:2014,trimblendgarciniacambogia,http://goodpreview.info/trimblendgarciniacambogia,72,72,0
04:04:2014,triminexgarciniacambogia,http://goodpreview.info/triminexgarciniacambogia,84,87,-3
04:04:2014,triminexgreencoffee,http://goodpreview.info/triminexgreencoffee,52,53,-1
04:04:2014,tripleeffectseyeserum,http://goodpreview.info/tripleeffectseyeserum,598,603,-5
04:04:2014,turboextracut,http://goodpreview.info/turboextracut,158,160,-2
04:04:2014,turboshred,http://goodpreview.info/turboshred,100,100,0
04:04:2014,ultimategarcinia,http://goodpreview.info/ultimategarcinia,164,164,0
04:04:2014,ultramaxtestosterone,http://goodpreview.info/ultramaxtestosterone,33,33,0
04:04:2014,ultrapurecoloncleanse,http://goodpreview.info/ultrapurecoloncleanse,1,4,-3
04:04:2014,ultraraspberryketone,http://goodpreview.info/ultraraspberryketone,418,418,0
04:04:2014,velora,http://goodpreview.info/velora,23,23,0
04:04:2014,velveskin,http://goodpreview.info/velveskin,14,17,-3
04:04:2014,vencleanse,http://goodpreview.info/vencleanse,429,431,-2
04:04:2014,viarex,http://goodpreview.info/viarex,598,599,-1
04:04:2014,vitalifedetox,http://goodpreview.info/vitalifedetox,254,255,-1
04:04:2014,vitalitygreencoffee,http://goodpreview.info/vitalitygreencoffee,85,85,0
04:04:2014,vitamax,http://goodpreview.info/vitamax,22,22,0
04:04:2014,vitolipo,http://goodpreview.info/vitolipo,1131,1135,-4
04:04:2014,vydox,http://goodpreview.info/vydox,302,307,-5
04:04:2014,wildraspberryketone,http://goodpreview.info/wildraspberryketone,169,174,-5
04:04:2014,wrinklesscream,http://goodpreview.info/wrinklesscream,270,273,-3
04:04:2014,xenaslim,http://goodpreview.info/xenaslim,41,41,0
04:04:2014,xengthx1,http://goodpreview.info/xengthx1,30,32,-2
04:04:2014,xlerator,http://goodpreview.info/xlerator,0,0,0
04:04:2014,xocigs,http://goodpreview.info/xocigs,64,65,-1
04:04:2014,xtgenix,http://goodpreview.info/xtgenix,12941,12953,-12
04:04:2014,xtrememusclepro,http://goodpreview.info/xtrememusclepro,607,608,-1
04:04:2014,yaconsplash,http://goodpreview.info/yaconsplash,21,21,0
04:04:2014,yaconsyruporiginal,http://goodpreview.info/yaconsyruporiginal,94,94,0
04:04:2014,yaconsyrupsecret,http://goodpreview.info/yaconsyrupsecret,32,32,0
04:04:2014,yoloboost,http://goodpreview.info/yoloboost,2,2,0
04:04:2014,youthkiteyecream,http://goodpreview.info/youthkiteyecream,242,244,-2
