date,sitetitle,sitelink,pre_click,present_click,deff
31:03:2014,11fruits,http://goodpreview.info/11fruits,191,194,-3
31:03:2014,1285muscle,http://goodpreview.info/1285muscle,2845,2851,-6
31:03:2014,92trimgreencoffee,http://goodpreview.info/92trimgreencoffee,35,35,0
31:03:2014,Americig,http://goodpreview.info/Americig,386,388,-2
31:03:2014,Nuvagenic,http://goodpreview.info/Nuvagenic,1085,1087,-2
31:03:2014,Prolexin,http://goodpreview.info/Prolexin,620,678,-58
31:03:2014,SVELME,http://goodpreview.info/SVELME,787,788,-1
31:03:2014,SlimSpray,http://goodpreview.info/SlimSpray,251,253,-2
31:03:2014,acaiberryfresh,http://goodpreview.info/acaiberryfresh,95,95,0
31:03:2014,acainatural,http://goodpreview.info/acainatural,132,132,0
31:03:2014,acaiultralean,http://goodpreview.info/acaiultralean,129,129,0
31:03:2014,advancedgarciniacambogia,http://goodpreview.info/advancedgarciniacambogia,880,881,-1
31:03:2014,advancedgarciniacambogia-fr,http://goodpreview.info/advancedgarciniacambogia-fr,103,106,-3
31:03:2014,advancedgarciniacambogia1,http://goodpreview.info/advancedgarciniacambogia1,5,11,-6
31:03:2014,advancedkrealkalyn,http://goodpreview.info/advancedkrealkalyn,144,145,-1
31:03:2014,advancedpurecleanse,http://goodpreview.info/advancedpurecleanse,0,0,0
31:03:2014,advancedpurecleanse1,http://goodpreview.info/advancedpurecleanse1,6,13,-7
31:03:2014,africanmangoboost,http://goodpreview.info/africanmangoboost,117,118,-1
31:03:2014,africanmangoprox,http://goodpreview.info/africanmangoprox,42,42,0
31:03:2014,africanmangopure,http://goodpreview.info/africanmangopure,76,76,0
31:03:2014,aktiveam,http://goodpreview.info/aktiveam,1582,1591,-9
31:03:2014,aktivepm,http://goodpreview.info/aktivepm,1935,1969,-34
31:03:2014,alphajacked,http://goodpreview.info/alphajacked,769,769,0
31:03:2014,alphamaxplus,http://goodpreview.info/alphamaxplus,8,10,-2
31:03:2014,amazing,http://goodpreview.info/amazing,249,286,-37
31:03:2014,aminomuscle,http://goodpreview.info/aminomuscle,1172,1176,-4
31:03:2014,aminoprime,http://goodpreview.info/aminoprime,104,106,-2
31:03:2014,aminoprimexl,http://goodpreview.info/aminoprimexl,269,273,-4
31:03:2014,anabolicrx24,http://goodpreview.info/anabolicrx24,16537,16760,-223
31:03:2014,anatomyx5,http://goodpreview.info/anatomyx5,3,3,0
31:03:2014,androsolve,http://goodpreview.info/androsolve,1468,1469,-1
31:03:2014,androx,http://goodpreview.info/androx,10798,11475,-677
31:03:2014,anoradrol,http://goodpreview.info/anoradrol,207,210,-3
31:03:2014,auravie,http://goodpreview.info/auravie,104,104,0
31:03:2014,authenticgreencoffee,http://goodpreview.info/authenticgreencoffee,239,240,-1
31:03:2014,beaudify,http://goodpreview.info/beaudify,58,63,-5
31:03:2014,beautefxbbcream,http://goodpreview.info/beautefxbbcream,2,2,0
31:03:2014,beautynectarcollagen,http://goodpreview.info/beautynectarcollagen,131,131,0
31:03:2014,beddefense,http://goodpreview.info/beddefense,20,24,-4
31:03:2014,bellagenix,http://goodpreview.info/bellagenix,138,138,0
31:03:2014,bellalabs,http://goodpreview.info/bellalabs,7,7,0
31:03:2014,bellaplex,http://goodpreview.info/bellaplex,106,109,-3
31:03:2014,beriultimatepro,http://goodpreview.info/beriultimatepro,68,68,0
31:03:2014,berrythin,http://goodpreview.info/berrythin,322,323,-1
31:03:2014,betaalaninemax,http://goodpreview.info/betaalaninemax,0,0,0
31:03:2014,betaalaninextreme,http://goodpreview.info/betaalaninextreme,12,14,-2
31:03:2014,beyondraspberry,http://goodpreview.info/beyondraspberry,73,74,-1
31:03:2014,biohealthgarciniacambogia,http://goodpreview.info/biohealthgarciniacambogia,3279,3328,-49
31:03:2014,biomelt,http://goodpreview.info/biomelt,293,293,0
31:03:2014,blastxl,http://goodpreview.info/blastxl,143,144,-1
31:03:2014,bodycleanseplus,http://goodpreview.info/bodycleanseplus,65,66,-1
31:03:2014,bodywrap,http://goodpreview.info/bodywrap,201,204,-3
31:03:2014,breakfree,http://goodpreview.info/breakfree,111,111,0
31:03:2014,cambogiatrim,http://goodpreview.info/cambogiatrim,595,595,0
31:03:2014,capsicum,http://goodpreview.info/capsicum,137,137,0
31:03:2014,celebritycleanser,http://goodpreview.info/celebritycleanser,33,48,-15
31:03:2014,celebrityraspberry,http://goodpreview.info/celebrityraspberry,134,134,0
31:03:2014,cellanafricanmango,http://goodpreview.info/cellanafricanmango,232,234,-2
31:03:2014,cellogicaskin,http://goodpreview.info/cellogicaskin,43,46,-3
31:03:2014,centrislim,http://goodpreview.info/centrislim,195,197,-2
31:03:2014,certifiedgreencoffee,http://goodpreview.info/certifiedgreencoffee,147,147,0
31:03:2014,certifiedpuregreencoffee,http://goodpreview.info/certifiedpuregreencoffee,19,19,0
31:03:2014,chiocegreencoffee,http://goodpreview.info/chiocegreencoffee,545,545,0
31:03:2014,choicegreencoffee,http://goodpreview.info/choicegreencoffee,304,329,-25
31:03:2014,cleansefx,http://goodpreview.info/cleansefx,8643,8749,-106
31:03:2014,cleanseplus,http://goodpreview.info/cleanseplus,358,361,-3
31:03:2014,cleanseplus1,http://goodpreview.info/cleanseplus1,0,0,0
31:03:2014,cleansepremium,http://goodpreview.info/cleansepremium,15,15,0
31:03:2014,cleansewonder,http://goodpreview.info/cleansewonder,194,194,0
31:03:2014,cleansextrem,http://goodpreview.info/cleansextrem,1581,1629,-48
31:03:2014,cleantrim,http://goodpreview.info/cleantrim,222,225,-3
31:03:2014,clearcleansepro,http://goodpreview.info/clearcleansepro,101,105,-4
31:03:2014,clearsmoke,http://goodpreview.info/clearsmoke,170,173,-3
31:03:2014,codered7,http://goodpreview.info/codered7,277,284,-7
31:03:2014,coleanse,http://goodpreview.info/coleanse,122,122,0
31:03:2014,collaton,http://goodpreview.info/collaton,88,88,0
31:03:2014,colocleansepro,http://goodpreview.info/colocleansepro,0,0,0
31:03:2014,coloncleansetotal,http://goodpreview.info/coloncleansetotal,8,11,-3
31:03:2014,colonpurecleanse,http://goodpreview.info/colonpurecleanse,130,130,0
31:03:2014,colothin,http://goodpreview.info/colothin,983,986,-3
31:03:2014,completecoffeecleanse,http://goodpreview.info/completecoffeecleanse,1962,1967,-5
31:03:2014,complexiderm,http://goodpreview.info/complexiderm,100,102,-2
31:03:2014,corecutter,http://goodpreview.info/corecutter,19,20,-1
31:03:2014,csorex,http://goodpreview.info/csorex,170,172,-2
31:03:2014,dailyfacelift,http://goodpreview.info/dailyfacelift,89,90,-1
31:03:2014,dailyfacestemcelltechnology,http://goodpreview.info/dailyfacestemcelltechnology,189,189,0
31:03:2014,dailypowercleanse,http://goodpreview.info/dailypowercleanse,90,96,-6
31:03:2014,deerantlerxtreme,http://goodpreview.info/deerantlerxtreme,126,128,-2
31:03:2014,dermarose,http://goodpreview.info/dermarose,112,112,0
31:03:2014,dermaset,http://goodpreview.info/dermaset,45,46,-1
31:03:2014,dermpure,http://goodpreview.info/dermpure,80,80,0
31:03:2014,dietgreencoffeebean,http://goodpreview.info/dietgreencoffeebean,304,304,0
31:03:2014,drillpill,http://goodpreview.info/drillpill,448,451,-3
31:03:2014,elevategf,http://goodpreview.info/elevategf,167,171,-4
31:03:2014,elier,http://goodpreview.info/elier,50,50,0
31:03:2014,elierskincare,http://goodpreview.info/elierskincare,39,40,-1
31:03:2014,elitetest360,http://goodpreview.info/elitetest360,349,385,-36
31:03:2014,emeraldluxecig,http://goodpreview.info/emeraldluxecig,110,110,0
31:03:2014,enduros,http://goodpreview.info/enduros,926,942,-16
31:03:2014,envigra,http://goodpreview.info/envigra,102,102,0
31:03:2014,estrodetox,http://goodpreview.info/estrodetox,92,92,0
31:03:2014,extentxl,http://goodpreview.info/extentxl,171,171,0
31:03:2014,fembalance,http://goodpreview.info/fembalance,17,17,0
31:03:2014,flawlessraspberryketone,http://goodpreview.info/flawlessraspberryketone,68,72,-4
31:03:2014,formulat10,http://goodpreview.info/formulat10,1487,1497,-10
31:03:2014,garcinaiawow1,http://goodpreview.info/garcinaiawow1,2529,2562,-33
31:03:2014,garciniacambogia,http://goodpreview.info/garciniacambogia,1075,1164,-89
31:03:2014,garciniacambogia1000,http://goodpreview.info/garciniacambogia1000,61,61,0
31:03:2014,garciniacambogiaelite,http://goodpreview.info/garciniacambogiaelite,5076,5127,-51
31:03:2014,garciniacambogiafatbuster,http://goodpreview.info/garciniacambogiafatbuster,88,89,-1
31:03:2014,garciniacambogiamax,http://goodpreview.info/garciniacambogiamax,2384,2387,-3
31:03:2014,garciniacambogiamiracle,http://goodpreview.info/garciniacambogiamiracle,120,126,-6
31:03:2014,garciniacambogiapremium,http://goodpreview.info/garciniacambogiapremium,1074,1074,0
31:03:2014,garciniacambogiapureextract,http://goodpreview.info/garciniacambogiapureextract,136,139,-3
31:03:2014,garciniacambogiapureselect,http://goodpreview.info/garciniacambogiapureselect,569,575,-6
31:03:2014,garciniacambogiasupreme,http://goodpreview.info/garciniacambogiasupreme,2576,2719,-143
31:03:2014,garciniacambogiatoday,http://goodpreview.info/garciniacambogiatoday,99,108,-9
31:03:2014,garciniacambogiaultra,http://goodpreview.info/garciniacambogiaultra,345,348,-3
31:03:2014,garciniaforte,http://goodpreview.info/garciniaforte,2619,2646,-27
31:03:2014,garciniafreetrial,http://goodpreview.info/garciniafreetrial,64,66,-2
31:03:2014,garciniagreen,http://goodpreview.info/garciniagreen,818,826,-8
31:03:2014,garciniapureelite1,http://goodpreview.info/garciniapureelite1,1,1,0
31:03:2014,garciniatoday,http://goodpreview.info/garciniatoday,0,0,0
31:03:2014,garciniatotal,http://goodpreview.info/garciniatotal,76,77,-1
31:03:2014,garciniawow,http://goodpreview.info/garciniawow,579,659,-80
31:03:2014,garcinium,http://goodpreview.info/garcinium,24,82,-58
31:03:2014,gc7x,http://goodpreview.info/gc7x,99,101,-2
31:03:2014,gc7xgreencoffee,http://goodpreview.info/gc7xgreencoffee,0,0,0
31:03:2014,gcbultra,http://goodpreview.info/gcbultra,50,51,-1
31:03:2014,gcbx,http://goodpreview.info/gcbx,17046,17060,-14
31:03:2014,gcbx1,http://goodpreview.info/gcbx1,195,195,0
31:03:2014,gcspeedslim,http://goodpreview.info/gcspeedslim,5568,5596,-28
31:03:2014,gcultra,http://goodpreview.info/gcultra,132,132,0
31:03:2014,gcultragarcinia,http://goodpreview.info/gcultragarcinia,4,4,0
31:03:2014,geneme,http://goodpreview.info/geneme,39,39,0
31:03:2014,getnaturalgarcinia,http://goodpreview.info/getnaturalgarcinia,40,40,0
31:03:2014,greencoffeeadvanced,http://goodpreview.info/greencoffeeadvanced,180,180,0
31:03:2014,greencoffeebean8000,http://goodpreview.info/greencoffeebean8000,66,66,0
31:03:2014,greencoffeebody,http://goodpreview.info/greencoffeebody,33,33,0
31:03:2014,greencoffeeburn,http://goodpreview.info/greencoffeeburn,22,22,0
31:03:2014,greencoffeeextreme,http://goodpreview.info/greencoffeeextreme,84,84,0
31:03:2014,greencoffeemax,http://goodpreview.info/greencoffeemax,123,123,0
31:03:2014,greencoffeemaxx,http://goodpreview.info/greencoffeemaxx,0,2,-2
31:03:2014,greencoffeeoptimum,http://goodpreview.info/greencoffeeoptimum,122,122,0
31:03:2014,greencoffeeprogram,http://goodpreview.info/greencoffeeprogram,0,0,0
31:03:2014,greencoffeeultraslim,http://goodpreview.info/greencoffeeultraslim,201,201,0
31:03:2014,greentonepro,http://goodpreview.info/greentonepro,306,306,0
31:03:2014,healthetrimgarcinia,http://goodpreview.info/healthetrimgarcinia,148,148,0
31:03:2014,healthychoicegc,http://goodpreview.info/healthychoicegc,732,733,-1
31:03:2014,horsepowerplusxxxl,http://goodpreview.info/horsepowerplusxxxl,72,86,-14
31:03:2014,hugegenic,http://goodpreview.info/hugegenic,236,250,-14
31:03:2014,hydrellatone,http://goodpreview.info/hydrellatone,102,102,0
31:03:2014,hydrocollagen,http://goodpreview.info/hydrocollagen,42,42,0
31:03:2014,hydroderm,http://goodpreview.info/hydroderm,43,43,0
31:03:2014,hyperfuel9x,http://goodpreview.info/hyperfuel9x,1851,1874,-23
31:03:2014,illuminatedteeth,http://goodpreview.info/illuminatedteeth,25,31,-6
31:03:2014,instantwrinklerepair,http://goodpreview.info/instantwrinklerepair,18,18,0
31:03:2014,iqderma,http://goodpreview.info/iqderma,393,399,-6
31:03:2014,iqdermaessen,http://goodpreview.info/iqdermaessen,0,0,0
31:03:2014,ketoneoptimum,http://goodpreview.info/ketoneoptimum,150,150,0
31:03:2014,kleanslim,http://goodpreview.info/kleanslim,97,98,-1
31:03:2014,lacreme,http://goodpreview.info/lacreme,701,729,-28
31:03:2014,leanmuscleformula,http://goodpreview.info/leanmuscleformula,1339,1357,-18
31:03:2014,ledermeluxe,http://goodpreview.info/ledermeluxe,184,184,0
31:03:2014,leparfait,http://goodpreview.info/leparfait,3,6,-3
31:03:2014,leparisehydragold,http://goodpreview.info/leparisehydragold,55,58,-3
31:03:2014,levela,http://goodpreview.info/levela,101,102,-1
31:03:2014,lifedetox,http://goodpreview.info/lifedetox,142,144,-2
31:03:2014,liftserumpro,http://goodpreview.info/liftserumpro,177,179,-2
31:03:2014,liposlender,http://goodpreview.info/liposlender,22,22,0
31:03:2014,liposlim,http://goodpreview.info/liposlim,1821,1829,-8
31:03:2014,liposom,http://goodpreview.info/liposom,59,60,-1
31:03:2014,liveskinny,http://goodpreview.info/liveskinny,231,231,0
31:03:2014,lumahydrate,http://goodpreview.info/lumahydrate,289,322,-33
31:03:2014,lumarepair,http://goodpreview.info/lumarepair,429,438,-9
31:03:2014,lunathin,http://goodpreview.info/lunathin,120,121,-1
31:03:2014,luxoderm,http://goodpreview.info/luxoderm,162,180,-18
31:03:2014,lysocleanse,http://goodpreview.info/lysocleanse,1666,1696,-30
31:03:2014,maxdetoxpro,http://goodpreview.info/maxdetoxpro,568,568,0
31:03:2014,maxgarciniaburn,http://goodpreview.info/maxgarciniaburn,455,455,0
31:03:2014,maximumshred,http://goodpreview.info/maximumshred,1485,1497,-12
31:03:2014,maxrobust,http://goodpreview.info/maxrobust,237,244,-7
31:03:2014,maxrobustxtreme,http://goodpreview.info/maxrobustxtreme,520,520,0
31:03:2014,mightyraspberryketone,http://goodpreview.info/mightyraspberryketone,5075,5081,-6
31:03:2014,miraclegarciniacambogia,http://goodpreview.info/miraclegarciniacambogia,425,440,-15
31:03:2014,miraclegreencoffee,http://goodpreview.info/miraclegreencoffee,413,426,-13
31:03:2014,miraclesaffron,http://goodpreview.info/miraclesaffron,39,40,-1
31:03:2014,mitoslim,http://goodpreview.info/mitoslim,2049,2050,-1
31:03:2014,musclefactorx,http://goodpreview.info/musclefactorx,1422,1423,-1
31:03:2014,musclefactorx-1,http://goodpreview.info/musclefactorx-1,20,20,0
31:03:2014,musclekingpro,http://goodpreview.info/musclekingpro,496,497,-1
31:03:2014,musclemaxextreme,http://goodpreview.info/musclemaxextreme,136,136,0
31:03:2014,muscleplus,http://goodpreview.info/muscleplus,136,138,-2
31:03:2014,musclerevolutionpro,http://goodpreview.info/musclerevolutionpro,1377,1385,-8
31:03:2014,musclerevx,http://goodpreview.info/musclerevx,65,71,-6
31:03:2014,musclerevxtreme,http://goodpreview.info/musclerevxtreme,53,55,-2
31:03:2014,musclexlerator,http://goodpreview.info/musclexlerator,9,18,-9
31:03:2014,musclexmax,http://goodpreview.info/musclexmax,1356,1358,-2
31:03:2014,musclexmax1,http://goodpreview.info/musclexmax1,270,270,0
31:03:2014,musclezx90,http://goodpreview.info/musclezx90,4907,4918,-11
31:03:2014,naturalcleanse,http://goodpreview.info/naturalcleanse,7922,7950,-28
31:03:2014,naturalgarciniacambogia,http://goodpreview.info/naturalgarciniacambogia,2733,2739,-6
31:03:2014,naturalgreencoffee,http://goodpreview.info/naturalgreencoffee,7,7,0
31:03:2014,naturalhealthgarcinia,http://goodpreview.info/naturalhealthgarcinia,46,47,-1
31:03:2014,naturalpurecleanse,http://goodpreview.info/naturalpurecleanse,1473,1501,-28
31:03:2014,nauseam,http://goodpreview.info/nauseam,132,133,-1
31:03:2014,nauseamplus,http://goodpreview.info/nauseamplus,0,0,0
31:03:2014,nextrim,http://goodpreview.info/nextrim,1699,1712,-13
31:03:2014,nitricmusclemax,http://goodpreview.info/nitricmusclemax,12514,12711,-197
31:03:2014,nitrofocusno3,http://goodpreview.info/nitrofocusno3,40,45,-5
31:03:2014,niwali,http://goodpreview.info/niwali,775,780,-5
31:03:2014,no2explodeextreme,http://goodpreview.info/no2explodeextreme,156,158,-2
31:03:2014,no2extremerush,http://goodpreview.info/no2extremerush,1294,1296,-2
31:03:2014,noflameecigs,http://goodpreview.info/noflameecigs,350,350,0
31:03:2014,nuclearno,http://goodpreview.info/nuclearno,362,363,-1
31:03:2014,nuetrim,http://goodpreview.info/nuetrim,656,656,0
31:03:2014,nutragreencoffee,http://goodpreview.info/nutragreencoffee,3488,3492,-4
31:03:2014,nutrapuregarcinia,http://goodpreview.info/nutrapuregarcinia,197,201,-4
31:03:2014,nutratoneplus,http://goodpreview.info/nutratoneplus,941,955,-14
31:03:2014,nutriberryslim,http://goodpreview.info/nutriberryslim,968,998,-30
31:03:2014,nuvoryn,http://goodpreview.info/nuvoryn,22,22,0
31:03:2014,optimalstack,http://goodpreview.info/optimalstack,1614,1617,-3
31:03:2014,optimummuscle,http://goodpreview.info/optimummuscle,196,198,-2
31:03:2014,organicgreencoffee,http://goodpreview.info/organicgreencoffee,88,88,0
31:03:2014,organicwhitekidneybean,http://goodpreview.info/organicwhitekidneybean,88,89,-1
31:03:2014,orviax,http://goodpreview.info/orviax,88,88,0
31:03:2014,oxitamin,http://goodpreview.info/oxitamin,146,146,0
31:03:2014,phtytoceramides,http://goodpreview.info/phtytoceramides,773,781,-8
31:03:2014,powerigf,http://goodpreview.info/powerigf,1607,1663,-56
31:03:2014,powerpumpxl,http://goodpreview.info/powerpumpxl,364,365,-1
31:03:2014,powerup,http://goodpreview.info/powerup,112,112,0
31:03:2014,premiermangocleanse,http://goodpreview.info/premiermangocleanse,488,496,-8
31:03:2014,premiumcleanse,http://goodpreview.info/premiumcleanse,2659,2697,-38
31:03:2014,premiumgarciniacambogia,http://goodpreview.info/premiumgarciniacambogia,392,397,-5
31:03:2014,premiumgarciniaextract,http://goodpreview.info/premiumgarciniaextract,518,579,-61
31:03:2014,premiumgreencoffee,http://goodpreview.info/premiumgreencoffee,118,118,0
31:03:2014,premiumgreencoffee800,http://goodpreview.info/premiumgreencoffee800,107,107,0
31:03:2014,premiumraspberryketone,http://goodpreview.info/premiumraspberryketone,43,43,0
31:03:2014,primalitegarciniaextract,http://goodpreview.info/primalitegarciniaextract,652,677,-25
31:03:2014,progain350,http://goodpreview.info/progain350,148,174,-26
31:03:2014,prograce,http://goodpreview.info/prograce,162,1,161
31:03:2014,promusclecomplex,http://goodpreview.info/promusclecomplex,48,48,0
31:03:2014,propowercleanse,http://goodpreview.info/propowercleanse,622,789,-167
31:03:2014,pureberrymax,http://goodpreview.info/pureberrymax,212,212,0
31:03:2014,purecleansehealth,http://goodpreview.info/purecleansehealth,106,107,-1
31:03:2014,purecollagen,http://goodpreview.info/purecollagen,2202,2204,-2
31:03:2014,puregarciniacambogia,http://goodpreview.info/puregarciniacambogia,1190,1196,-6
31:03:2014,puregarciniaslim,http://goodpreview.info/puregarciniaslim,121,127,-6
31:03:2014,puregreencoffeebeanextract,http://goodpreview.info/puregreencoffeebeanextract,2683,2691,-8
31:03:2014,puregreencoffeemaxima,http://goodpreview.info/puregreencoffeemaxima,35,36,-1
31:03:2014,puregriffonia,http://goodpreview.info/puregriffonia,95,96,-1
31:03:2014,pureketoneslim,http://goodpreview.info/pureketoneslim,29,29,0
31:03:2014,purelifeclanse,http://goodpreview.info/purelifeclanse,99,101,-2
31:03:2014,puremusclepro,http://goodpreview.info/puremusclepro,1790,1794,-4
31:03:2014,purenaturalcleanser,http://goodpreview.info/purenaturalcleanser,476,476,0
31:03:2014,purephytoceramides,http://goodpreview.info/purephytoceramides,65,68,-3
31:03:2014,pureraspberryketonepremium,http://goodpreview.info/pureraspberryketonepremium,62,62,0
31:03:2014,puresaffronslim,http://goodpreview.info/puresaffronslim,422,422,0
31:03:2014,pureslim57,http://goodpreview.info/pureslim57,124,124,0
31:03:2014,purgarciniacambogia,http://goodpreview.info/purgarciniacambogia,155,156,-1
31:03:2014,purgreencoffee,http://goodpreview.info/purgreencoffee,1622,1622,0
31:03:2014,purifyre,http://goodpreview.info/purifyre,241,241,0
31:03:2014,purifyregreencoffee,http://goodpreview.info/purifyregreencoffee,0,0,0
31:03:2014,raspberryhealth,http://goodpreview.info/raspberryhealth,37,39,-2
31:03:2014,raspberryketoneblast,http://goodpreview.info/raspberryketoneblast,3925,3985,-60
31:03:2014,raspberryketoned,http://goodpreview.info/raspberryketoned,2,2,0
31:03:2014,raspberryketoneoptimum,http://goodpreview.info/raspberryketoneoptimum,5,5,0
31:03:2014,raspberryketonepremium,http://goodpreview.info/raspberryketonepremium,75,76,-1
31:03:2014,raspberryketonepure,http://goodpreview.info/raspberryketonepure,2,2,0
31:03:2014,raspberryketonethin,http://goodpreview.info/raspberryketonethin,370,401,-31
31:03:2014,raspberryslimplus,http://goodpreview.info/raspberryslimplus,124,125,-1
31:03:2014,refuelextreme,http://goodpreview.info/refuelextreme,445,452,-7
31:03:2014,regalecig,http://goodpreview.info/regalecig,344,352,-8
31:03:2014,regalecigs,http://goodpreview.info/regalecigs,38,39,-1
31:03:2014,rejuvaglow,http://goodpreview.info/rejuvaglow,67,68,-1
31:03:2014,rejuveneyemax,http://goodpreview.info/rejuveneyemax,317,1,316
31:03:2014,rellift,http://goodpreview.info/rellift,29,29,0
31:03:2014,renovo,http://goodpreview.info/renovo,2,23,-21
31:03:2014,restiflex,http://goodpreview.info/restiflex,61,62,-1
31:03:2014,revitalize,http://goodpreview.info/revitalize,24,24,0
31:03:2014,revitatone,http://goodpreview.info/revitatone,8529,8651,-122
31:03:2014,revolutionaryraspberryketone,http://goodpreview.info/revolutionaryraspberryketone,65,65,0
31:03:2014,revoreplex,http://goodpreview.info/revoreplex,114,114,0
31:03:2014,revtesttestosterone,http://goodpreview.info/revtesttestosterone,1585,1587,-2
31:03:2014,rippedmusclex,http://goodpreview.info/rippedmusclex,147,154,-7
31:03:2014,rippedxburn,http://goodpreview.info/rippedxburn,181,181,0
31:03:2014,sacredarganoil,http://goodpreview.info/sacredarganoil,43,44,-1
31:03:2014,safercolon,http://goodpreview.info/safercolon,2876,2928,-52
31:03:2014,saffronextractpremium,http://goodpreview.info/saffronextractpremium,104,104,0
31:03:2014,saffronextractselect,http://goodpreview.info/saffronextractselect,1320,1337,-17
31:03:2014,saffronselect,http://goodpreview.info/saffronselect,71,71,0
31:03:2014,secretgreencoffee,http://goodpreview.info/secretgreencoffee,236,241,-5
31:03:2014,simpleantiaging,http://goodpreview.info/simpleantiaging,226,226,0
31:03:2014,simplygarcinia,http://goodpreview.info/simplygarcinia,960,992,-32
31:03:2014,skinlift,http://goodpreview.info/skinlift,2133,2141,-8
31:03:2014,slendera,http://goodpreview.info/slendera,14,15,-1
31:03:2014,slenderagc-1,http://goodpreview.info/slenderagc-1,373,382,-9
31:03:2014,slimatrex,http://goodpreview.info/slimatrex,609,609,0
31:03:2014,slimhelper,http://goodpreview.info/slimhelper,243,244,-1
31:03:2014,slimher,http://goodpreview.info/slimher,171,171,0
31:03:2014,slimmeryougarcinia,http://goodpreview.info/slimmeryougarcinia,0,0,0
31:03:2014,slimtropical,http://goodpreview.info/slimtropical,792,794,-2
31:03:2014,slimtropicalmx,http://goodpreview.info/slimtropicalmx,129,133,-4
31:03:2014,slimzenu,http://goodpreview.info/slimzenu,197,197,0
31:03:2014,smokestarecig,http://goodpreview.info/smokestarecig,509,510,-1
31:03:2014,solpriaxtreme,http://goodpreview.info/solpriaxtreme,2738,2758,-20
31:03:2014,sorepressin,http://goodpreview.info/sorepressin,4,4,0
31:03:2014,speedtrimxs,http://goodpreview.info/speedtrimxs,89,89,0
31:03:2014,splendyr,http://goodpreview.info/splendyr,1268,1271,-3
31:03:2014,splendyrantiaging,http://goodpreview.info/splendyrantiaging,51,51,0
31:03:2014,superacaicleanse,http://goodpreview.info/superacaicleanse,19,19,0
31:03:2014,supercleansetotal,http://goodpreview.info/supercleansetotal,46,52,-6
31:03:2014,supergreencoffee,http://goodpreview.info/supergreencoffee,10,10,0
31:03:2014,supergreencoffeebean,http://goodpreview.info/supergreencoffeebean,20,20,0
31:03:2014,superiormusclex,http://goodpreview.info/superiormusclex,68,74,-6
31:03:2014,superiorvelvet,http://goodpreview.info/superiorvelvet,1,1,0
31:03:2014,superyacon1000,http://goodpreview.info/superyacon1000,16,17,-1
31:03:2014,supracleanse350,http://goodpreview.info/supracleanse350,0,0,0
31:03:2014,supragreencoffee,http://goodpreview.info/supragreencoffee,855,873,-18
31:03:2014,supragreencoffeebean,http://goodpreview.info/supragreencoffeebean,0,0,0
31:03:2014,surelyyoung,http://goodpreview.info/surelyyoung,26,26,0
31:03:2014,swissrose,http://goodpreview.info/swissrose,333,336,-3
31:03:2014,swolekreate,http://goodpreview.info/swolekreate,189,189,0
31:03:2014,syneocell,http://goodpreview.info/syneocell,46,48,-2
31:03:2014,t-force,http://goodpreview.info/t-force,163,168,-5
31:03:2014,testforcextreme,http://goodpreview.info/testforcextreme,486,486,0
31:03:2014,testoforce,http://goodpreview.info/testoforce,12,12,0
31:03:2014,testorushrx,http://goodpreview.info/testorushrx,35,37,-2
31:03:2014,testosteronemax,http://goodpreview.info/testosteronemax,312,321,-9
31:03:2014,testoxl,http://goodpreview.info/testoxl,1441,1455,-14
31:03:2014,thinmagic,http://goodpreview.info/thinmagic,234,235,-1
31:03:2014,thinmagicmax,http://goodpreview.info/thinmagicmax,0,0,0
31:03:2014,thinsport,http://goodpreview.info/thinsport,211,211,0
31:03:2014,titaniumprox,http://goodpreview.info/titaniumprox,0,0,0
31:03:2014,totalbodyfresh,http://goodpreview.info/totalbodyfresh,107,109,-2
31:03:2014,trigx2,http://goodpreview.info/trigx2,1,4,-3
31:03:2014,trimaleana,http://goodpreview.info/trimaleana,135,135,0
31:03:2014,trimatol,http://goodpreview.info/trimatol,115,118,-3
31:03:2014,trimblendgarciniacambogia,http://goodpreview.info/trimblendgarciniacambogia,71,71,0
31:03:2014,triminexgarciniacambogia,http://goodpreview.info/triminexgarciniacambogia,77,77,0
31:03:2014,triminexgreencoffee,http://goodpreview.info/triminexgreencoffee,46,49,-3
31:03:2014,tripleeffectseyeserum,http://goodpreview.info/tripleeffectseyeserum,583,589,-6
31:03:2014,turboextracut,http://goodpreview.info/turboextracut,154,155,-1
31:03:2014,turboshred,http://goodpreview.info/turboshred,99,100,-1
31:03:2014,ultimategarcinia,http://goodpreview.info/ultimategarcinia,162,162,0
31:03:2014,ultramaxtestosterone,http://goodpreview.info/ultramaxtestosterone,33,33,0
31:03:2014,ultrapurecoloncleanse,http://goodpreview.info/ultrapurecoloncleanse,347,348,-1
31:03:2014,ultraraspberryketone,http://goodpreview.info/ultraraspberryketone,418,418,0
31:03:2014,velora,http://goodpreview.info/velora,22,22,0
31:03:2014,velveskin,http://goodpreview.info/velveskin,4,7,-3
31:03:2014,vencleanse,http://goodpreview.info/vencleanse,424,425,-1
31:03:2014,viarex,http://goodpreview.info/viarex,586,587,-1
31:03:2014,vitalifedetox,http://goodpreview.info/vitalifedetox,253,253,0
31:03:2014,vitalitygreencoffee,http://goodpreview.info/vitalitygreencoffee,84,84,0
31:03:2014,vitamax,http://goodpreview.info/vitamax,22,22,0
31:03:2014,vitolipo,http://goodpreview.info/vitolipo,1108,1113,-5
31:03:2014,vydox,http://goodpreview.info/vydox,284,290,-6
31:03:2014,wildraspberryketone,http://goodpreview.info/wildraspberryketone,138,140,-2
31:03:2014,wrinklesscream,http://goodpreview.info/wrinklesscream,233,252,-19
31:03:2014,xenaslim,http://goodpreview.info/xenaslim,35,40,-5
31:03:2014,xengthx1,http://goodpreview.info/xengthx1,28,29,-1
31:03:2014,xlerator,http://goodpreview.info/xlerator,0,0,0
31:03:2014,xocigs,http://goodpreview.info/xocigs,60,60,0
31:03:2014,xtgenix,http://goodpreview.info/xtgenix,12905,12913,-8
31:03:2014,xtrememusclepro,http://goodpreview.info/xtrememusclepro,602,604,-2
31:03:2014,yaconsplash,http://goodpreview.info/yaconsplash,18,18,0
31:03:2014,yaconsyruporiginal,http://goodpreview.info/yaconsyruporiginal,91,92,-1
31:03:2014,yaconsyrupsecret,http://goodpreview.info/yaconsyrupsecret,29,29,0
31:03:2014,yoloboost,http://goodpreview.info/yoloboost,134,135,-1
31:03:2014,youthkiteyecream,http://goodpreview.info/youthkiteyecream,239,239,0
31:03:2014,11fruits,http://goodpreview.info/11fruits,194,194,0
31:03:2014,1285muscle,http://goodpreview.info/1285muscle,2851,2852,-1
31:03:2014,92trimgreencoffee,http://goodpreview.info/92trimgreencoffee,35,35,0
31:03:2014,Americig,http://goodpreview.info/Americig,388,388,0
31:03:2014,Nuvagenic,http://goodpreview.info/Nuvagenic,1087,1087,0
31:03:2014,Prolexin,http://goodpreview.info/Prolexin,678,678,0
31:03:2014,SVELME,http://goodpreview.info/SVELME,788,788,0
31:03:2014,SlimSpray,http://goodpreview.info/SlimSpray,253,253,0
31:03:2014,acaiberryfresh,http://goodpreview.info/acaiberryfresh,95,95,0
31:03:2014,acainatural,http://goodpreview.info/acainatural,132,132,0
31:03:2014,acaiultralean,http://goodpreview.info/acaiultralean,129,129,0
31:03:2014,advancedgarciniacambogia,http://goodpreview.info/advancedgarciniacambogia,881,881,0
31:03:2014,advancedgarciniacambogia-fr,http://goodpreview.info/advancedgarciniacambogia-fr,106,106,0
31:03:2014,advancedgarciniacambogia1,http://goodpreview.info/advancedgarciniacambogia1,11,11,0
31:03:2014,advancedkrealkalyn,http://goodpreview.info/advancedkrealkalyn,145,145,0
31:03:2014,advancedpurecleanse,http://goodpreview.info/advancedpurecleanse,0,0,0
31:03:2014,advancedpurecleanse1,http://goodpreview.info/advancedpurecleanse1,13,13,0
31:03:2014,africanmangoboost,http://goodpreview.info/africanmangoboost,118,118,0
31:03:2014,africanmangoprox,http://goodpreview.info/africanmangoprox,42,42,0
31:03:2014,africanmangopure,http://goodpreview.info/africanmangopure,76,76,0
31:03:2014,aktiveam,http://goodpreview.info/aktiveam,1591,1591,0
31:03:2014,aktivepm,http://goodpreview.info/aktivepm,1969,1969,0
31:03:2014,alphajacked,http://goodpreview.info/alphajacked,769,769,0
31:03:2014,alphamaxplus,http://goodpreview.info/alphamaxplus,10,10,0
31:03:2014,amazing,http://goodpreview.info/amazing,286,286,0
31:03:2014,aminomuscle,http://goodpreview.info/aminomuscle,1176,1176,0
31:03:2014,aminoprime,http://goodpreview.info/aminoprime,106,106,0
31:03:2014,aminoprimexl,http://goodpreview.info/aminoprimexl,273,273,0
31:03:2014,anabolicrx24,http://goodpreview.info/anabolicrx24,16760,16762,-2
31:03:2014,anatomyx5,http://goodpreview.info/anatomyx5,3,3,0
31:03:2014,androsolve,http://goodpreview.info/androsolve,1469,1469,0
31:03:2014,androx,http://goodpreview.info/androx,11475,11477,-2
31:03:2014,anoradrol,http://goodpreview.info/anoradrol,210,210,0
31:03:2014,auravie,http://goodpreview.info/auravie,104,104,0
31:03:2014,authenticgreencoffee,http://goodpreview.info/authenticgreencoffee,240,240,0
31:03:2014,beaudify,http://goodpreview.info/beaudify,63,63,0
31:03:2014,beautefxbbcream,http://goodpreview.info/beautefxbbcream,2,2,0
31:03:2014,beautynectarcollagen,http://goodpreview.info/beautynectarcollagen,131,131,0
31:03:2014,beddefense,http://goodpreview.info/beddefense,24,24,0
31:03:2014,bellagenix,http://goodpreview.info/bellagenix,138,138,0
31:03:2014,bellalabs,http://goodpreview.info/bellalabs,7,7,0
31:03:2014,bellaplex,http://goodpreview.info/bellaplex,109,109,0
31:03:2014,beriultimatepro,http://goodpreview.info/beriultimatepro,68,68,0
31:03:2014,berrythin,http://goodpreview.info/berrythin,323,323,0
31:03:2014,betaalaninemax,http://goodpreview.info/betaalaninemax,0,0,0
31:03:2014,betaalaninextreme,http://goodpreview.info/betaalaninextreme,14,14,0
31:03:2014,beyondraspberry,http://goodpreview.info/beyondraspberry,74,74,0
31:03:2014,biohealthgarciniacambogia,http://goodpreview.info/biohealthgarciniacambogia,3328,3330,-2
31:03:2014,biomelt,http://goodpreview.info/biomelt,293,293,0
31:03:2014,blastxl,http://goodpreview.info/blastxl,144,144,0
31:03:2014,bodycleanseplus,http://goodpreview.info/bodycleanseplus,66,66,0
31:03:2014,bodywrap,http://goodpreview.info/bodywrap,204,204,0
31:03:2014,breakfree,http://goodpreview.info/breakfree,111,111,0
31:03:2014,cambogiatrim,http://goodpreview.info/cambogiatrim,595,595,0
31:03:2014,capsicum,http://goodpreview.info/capsicum,137,137,0
31:03:2014,celebritycleanser,http://goodpreview.info/celebritycleanser,48,48,0
31:03:2014,celebrityraspberry,http://goodpreview.info/celebrityraspberry,134,134,0
31:03:2014,cellanafricanmango,http://goodpreview.info/cellanafricanmango,234,234,0
31:03:2014,cellogicaskin,http://goodpreview.info/cellogicaskin,46,46,0
31:03:2014,centrislim,http://goodpreview.info/centrislim,197,197,0
31:03:2014,certifiedgreencoffee,http://goodpreview.info/certifiedgreencoffee,147,147,0
31:03:2014,certifiedpuregreencoffee,http://goodpreview.info/certifiedpuregreencoffee,19,19,0
31:03:2014,chiocegreencoffee,http://goodpreview.info/chiocegreencoffee,545,545,0
31:03:2014,choicegreencoffee,http://goodpreview.info/choicegreencoffee,329,329,0
31:03:2014,cleansefx,http://goodpreview.info/cleansefx,8749,8749,0
31:03:2014,cleanseplus,http://goodpreview.info/cleanseplus,361,361,0
31:03:2014,cleanseplus1,http://goodpreview.info/cleanseplus1,0,0,0
31:03:2014,cleansepremium,http://goodpreview.info/cleansepremium,15,15,0
31:03:2014,cleansewonder,http://goodpreview.info/cleansewonder,194,194,0
31:03:2014,cleansextrem,http://goodpreview.info/cleansextrem,1629,1629,0
31:03:2014,cleantrim,http://goodpreview.info/cleantrim,225,225,0
31:03:2014,clearcleansepro,http://goodpreview.info/clearcleansepro,105,105,0
31:03:2014,clearsmoke,http://goodpreview.info/clearsmoke,173,173,0
31:03:2014,codered7,http://goodpreview.info/codered7,284,284,0
31:03:2014,coleanse,http://goodpreview.info/coleanse,122,122,0
31:03:2014,collaton,http://goodpreview.info/collaton,88,88,0
31:03:2014,colocleansepro,http://goodpreview.info/colocleansepro,0,0,0
31:03:2014,coloncleansetotal,http://goodpreview.info/coloncleansetotal,11,11,0
31:03:2014,colonpurecleanse,http://goodpreview.info/colonpurecleanse,130,130,0
31:03:2014,colothin,http://goodpreview.info/colothin,986,986,0
31:03:2014,completecoffeecleanse,http://goodpreview.info/completecoffeecleanse,1967,1967,0
31:03:2014,complexiderm,http://goodpreview.info/complexiderm,102,102,0
31:03:2014,corecutter,http://goodpreview.info/corecutter,20,20,0
31:03:2014,csorex,http://goodpreview.info/csorex,172,172,0
31:03:2014,dailyfacelift,http://goodpreview.info/dailyfacelift,90,90,0
31:03:2014,dailyfacestemcelltechnology,http://goodpreview.info/dailyfacestemcelltechnology,189,189,0
31:03:2014,dailypowercleanse,http://goodpreview.info/dailypowercleanse,96,96,0
31:03:2014,deerantlerxtreme,http://goodpreview.info/deerantlerxtreme,128,128,0
31:03:2014,dermarose,http://goodpreview.info/dermarose,112,112,0
31:03:2014,dermaset,http://goodpreview.info/dermaset,46,46,0
31:03:2014,dermpure,http://goodpreview.info/dermpure,80,80,0
31:03:2014,dietgreencoffeebean,http://goodpreview.info/dietgreencoffeebean,304,304,0
31:03:2014,drillpill,http://goodpreview.info/drillpill,451,451,0
31:03:2014,elevategf,http://goodpreview.info/elevategf,171,171,0
31:03:2014,elier,http://goodpreview.info/elier,50,50,0
31:03:2014,elierskincare,http://goodpreview.info/elierskincare,40,40,0
31:03:2014,elitetest360,http://goodpreview.info/elitetest360,385,385,0
31:03:2014,emeraldluxecig,http://goodpreview.info/emeraldluxecig,110,111,-1
31:03:2014,enduros,http://goodpreview.info/enduros,942,942,0
31:03:2014,envigra,http://goodpreview.info/envigra,102,102,0
31:03:2014,estrodetox,http://goodpreview.info/estrodetox,92,92,0
31:03:2014,extentxl,http://goodpreview.info/extentxl,171,171,0
31:03:2014,fembalance,http://goodpreview.info/fembalance,17,17,0
31:03:2014,flawlessraspberryketone,http://goodpreview.info/flawlessraspberryketone,72,72,0
31:03:2014,formulat10,http://goodpreview.info/formulat10,1497,1497,0
31:03:2014,garcinaiawow1,http://goodpreview.info/garcinaiawow1,2562,2562,0
31:03:2014,garciniacambogia,http://goodpreview.info/garciniacambogia,1164,1164,0
31:03:2014,garciniacambogia1000,http://goodpreview.info/garciniacambogia1000,61,61,0
31:03:2014,garciniacambogiaelite,http://goodpreview.info/garciniacambogiaelite,5127,5127,0
31:03:2014,garciniacambogiafatbuster,http://goodpreview.info/garciniacambogiafatbuster,89,89,0
31:03:2014,garciniacambogiamax,http://goodpreview.info/garciniacambogiamax,2387,2387,0
31:03:2014,garciniacambogiamiracle,http://goodpreview.info/garciniacambogiamiracle,126,126,0
31:03:2014,garciniacambogiapremium,http://goodpreview.info/garciniacambogiapremium,1074,1074,0
31:03:2014,garciniacambogiapureextract,http://goodpreview.info/garciniacambogiapureextract,139,139,0
31:03:2014,garciniacambogiapureselect,http://goodpreview.info/garciniacambogiapureselect,575,575,0
31:03:2014,garciniacambogiasupreme,http://goodpreview.info/garciniacambogiasupreme,2719,2719,0
31:03:2014,garciniacambogiatoday,http://goodpreview.info/garciniacambogiatoday,108,108,0
31:03:2014,garciniacambogiaultra,http://goodpreview.info/garciniacambogiaultra,348,348,0
31:03:2014,garciniaforte,http://goodpreview.info/garciniaforte,2646,2646,0
31:03:2014,garciniafreetrial,http://goodpreview.info/garciniafreetrial,66,66,0
31:03:2014,garciniagreen,http://goodpreview.info/garciniagreen,826,826,0
31:03:2014,garciniapureelite1,http://goodpreview.info/garciniapureelite1,1,1,0
31:03:2014,garciniatoday,http://goodpreview.info/garciniatoday,0,0,0
31:03:2014,garciniatotal,http://goodpreview.info/garciniatotal,77,77,0
31:03:2014,garciniawow,http://goodpreview.info/garciniawow,659,661,-2
31:03:2014,garcinium,http://goodpreview.info/garcinium,82,84,-2
31:03:2014,gc7x,http://goodpreview.info/gc7x,101,101,0
31:03:2014,gc7xgreencoffee,http://goodpreview.info/gc7xgreencoffee,0,0,0
31:03:2014,gcbultra,http://goodpreview.info/gcbultra,51,51,0
31:03:2014,gcbx,http://goodpreview.info/gcbx,17060,17060,0
31:03:2014,gcbx1,http://goodpreview.info/gcbx1,195,195,0
31:03:2014,gcspeedslim,http://goodpreview.info/gcspeedslim,5596,5598,-2
31:03:2014,gcultra,http://goodpreview.info/gcultra,132,132,0
31:03:2014,gcultragarcinia,http://goodpreview.info/gcultragarcinia,4,4,0
31:03:2014,geneme,http://goodpreview.info/geneme,39,39,0
31:03:2014,getnaturalgarcinia,http://goodpreview.info/getnaturalgarcinia,40,40,0
31:03:2014,greencoffeeadvanced,http://goodpreview.info/greencoffeeadvanced,180,180,0
31:03:2014,greencoffeebean8000,http://goodpreview.info/greencoffeebean8000,66,66,0
31:03:2014,greencoffeebody,http://goodpreview.info/greencoffeebody,33,33,0
31:03:2014,greencoffeeburn,http://goodpreview.info/greencoffeeburn,22,22,0
31:03:2014,greencoffeeextreme,http://goodpreview.info/greencoffeeextreme,84,84,0
31:03:2014,greencoffeemax,http://goodpreview.info/greencoffeemax,123,123,0
31:03:2014,greencoffeemaxx,http://goodpreview.info/greencoffeemaxx,2,2,0
31:03:2014,greencoffeeoptimum,http://goodpreview.info/greencoffeeoptimum,122,122,0
31:03:2014,greencoffeeprogram,http://goodpreview.info/greencoffeeprogram,0,0,0
31:03:2014,greencoffeeultraslim,http://goodpreview.info/greencoffeeultraslim,201,201,0
31:03:2014,greentonepro,http://goodpreview.info/greentonepro,306,306,0
31:03:2014,healthetrimgarcinia,http://goodpreview.info/healthetrimgarcinia,148,148,0
31:03:2014,healthychoicegc,http://goodpreview.info/healthychoicegc,733,733,0
31:03:2014,horsepowerplusxxxl,http://goodpreview.info/horsepowerplusxxxl,86,86,0
31:03:2014,hugegenic,http://goodpreview.info/hugegenic,250,250,0
31:03:2014,hydrellatone,http://goodpreview.info/hydrellatone,102,102,0
31:03:2014,hydrocollagen,http://goodpreview.info/hydrocollagen,42,42,0
31:03:2014,hydroderm,http://goodpreview.info/hydroderm,43,43,0
31:03:2014,hyperfuel9x,http://goodpreview.info/hyperfuel9x,1874,1874,0
31:03:2014,illuminatedteeth,http://goodpreview.info/illuminatedteeth,31,31,0
31:03:2014,instantwrinklerepair,http://goodpreview.info/instantwrinklerepair,18,18,0
31:03:2014,iqderma,http://goodpreview.info/iqderma,399,399,0
31:03:2014,iqdermaessen,http://goodpreview.info/iqdermaessen,0,0,0
31:03:2014,ketoneoptimum,http://goodpreview.info/ketoneoptimum,150,150,0
31:03:2014,kleanslim,http://goodpreview.info/kleanslim,98,98,0
31:03:2014,lacreme,http://goodpreview.info/lacreme,729,730,-1
31:03:2014,leanmuscleformula,http://goodpreview.info/leanmuscleformula,1357,1357,0
31:03:2014,ledermeluxe,http://goodpreview.info/ledermeluxe,184,184,0
31:03:2014,leparfait,http://goodpreview.info/leparfait,6,6,0
31:03:2014,leparisehydragold,http://goodpreview.info/leparisehydragold,58,58,0
31:03:2014,levela,http://goodpreview.info/levela,102,102,0
31:03:2014,lifedetox,http://goodpreview.info/lifedetox,144,144,0
31:03:2014,liftserumpro,http://goodpreview.info/liftserumpro,179,179,0
31:03:2014,liposlender,http://goodpreview.info/liposlender,22,22,0
31:03:2014,liposlim,http://goodpreview.info/liposlim,1829,1829,0
31:03:2014,liposom,http://goodpreview.info/liposom,60,60,0
31:03:2014,liveskinny,http://goodpreview.info/liveskinny,231,232,-1
31:03:2014,lumahydrate,http://goodpreview.info/lumahydrate,322,322,0
31:03:2014,lumarepair,http://goodpreview.info/lumarepair,438,438,0
31:03:2014,lunathin,http://goodpreview.info/lunathin,121,121,0
31:03:2014,luxoderm,http://goodpreview.info/luxoderm,180,180,0
31:03:2014,lysocleanse,http://goodpreview.info/lysocleanse,1696,1698,-2
31:03:2014,maxdetoxpro,http://goodpreview.info/maxdetoxpro,568,568,0
31:03:2014,maxgarciniaburn,http://goodpreview.info/maxgarciniaburn,455,455,0
31:03:2014,maximumshred,http://goodpreview.info/maximumshred,1497,1497,0
31:03:2014,maxrobust,http://goodpreview.info/maxrobust,244,244,0
31:03:2014,maxrobustxtreme,http://goodpreview.info/maxrobustxtreme,520,520,0
31:03:2014,mightyraspberryketone,http://goodpreview.info/mightyraspberryketone,5081,5081,0
31:03:2014,miraclegarciniacambogia,http://goodpreview.info/miraclegarciniacambogia,440,440,0
31:03:2014,miraclegreencoffee,http://goodpreview.info/miraclegreencoffee,426,426,0
31:03:2014,miraclesaffron,http://goodpreview.info/miraclesaffron,40,40,0
31:03:2014,mitoslim,http://goodpreview.info/mitoslim,2050,2050,0
31:03:2014,musclefactorx,http://goodpreview.info/musclefactorx,1423,1423,0
31:03:2014,musclefactorx-1,http://goodpreview.info/musclefactorx-1,20,20,0
31:03:2014,musclekingpro,http://goodpreview.info/musclekingpro,497,497,0
31:03:2014,musclemaxextreme,http://goodpreview.info/musclemaxextreme,136,136,0
31:03:2014,muscleplus,http://goodpreview.info/muscleplus,138,138,0
31:03:2014,musclerevolutionpro,http://goodpreview.info/musclerevolutionpro,1385,1385,0
31:03:2014,musclerevx,http://goodpreview.info/musclerevx,71,71,0
31:03:2014,musclerevxtreme,http://goodpreview.info/musclerevxtreme,55,55,0
31:03:2014,musclexlerator,http://goodpreview.info/musclexlerator,18,18,0
31:03:2014,musclexmax,http://goodpreview.info/musclexmax,1358,1358,0
31:03:2014,musclexmax1,http://goodpreview.info/musclexmax1,270,270,0
31:03:2014,musclezx90,http://goodpreview.info/musclezx90,4918,4918,0
31:03:2014,naturalcleanse,http://goodpreview.info/naturalcleanse,7950,7950,0
31:03:2014,naturalgarciniacambogia,http://goodpreview.info/naturalgarciniacambogia,2739,2739,0
31:03:2014,naturalgreencoffee,http://goodpreview.info/naturalgreencoffee,7,7,0
31:03:2014,naturalhealthgarcinia,http://goodpreview.info/naturalhealthgarcinia,47,47,0
31:03:2014,naturalpurecleanse,http://goodpreview.info/naturalpurecleanse,1501,1501,0
31:03:2014,nauseam,http://goodpreview.info/nauseam,133,133,0
31:03:2014,nauseamplus,http://goodpreview.info/nauseamplus,0,0,0
31:03:2014,nextrim,http://goodpreview.info/nextrim,1712,1712,0
31:03:2014,nitricmusclemax,http://goodpreview.info/nitricmusclemax,12711,12715,-4
31:03:2014,nitrofocusno3,http://goodpreview.info/nitrofocusno3,45,45,0
31:03:2014,niwali,http://goodpreview.info/niwali,780,780,0
31:03:2014,no2explodeextreme,http://goodpreview.info/no2explodeextreme,158,158,0
31:03:2014,no2extremerush,http://goodpreview.info/no2extremerush,1296,1296,0
31:03:2014,noflameecigs,http://goodpreview.info/noflameecigs,350,350,0
31:03:2014,nuclearno,http://goodpreview.info/nuclearno,363,363,0
31:03:2014,nuetrim,http://goodpreview.info/nuetrim,656,656,0
31:03:2014,nutragreencoffee,http://goodpreview.info/nutragreencoffee,3492,3492,0
31:03:2014,nutrapuregarcinia,http://goodpreview.info/nutrapuregarcinia,201,201,0
31:03:2014,nutratoneplus,http://goodpreview.info/nutratoneplus,955,955,0
31:03:2014,nutriberryslim,http://goodpreview.info/nutriberryslim,998,999,-1
31:03:2014,nuvoryn,http://goodpreview.info/nuvoryn,22,22,0
31:03:2014,optimalstack,http://goodpreview.info/optimalstack,1617,1617,0
31:03:2014,optimummuscle,http://goodpreview.info/optimummuscle,198,198,0
31:03:2014,organicgreencoffee,http://goodpreview.info/organicgreencoffee,88,88,0
31:03:2014,organicwhitekidneybean,http://goodpreview.info/organicwhitekidneybean,89,89,0
31:03:2014,orviax,http://goodpreview.info/orviax,88,88,0
31:03:2014,oxitamin,http://goodpreview.info/oxitamin,146,146,0
31:03:2014,phtytoceramides,http://goodpreview.info/phtytoceramides,781,781,0
31:03:2014,powerigf,http://goodpreview.info/powerigf,1663,1664,-1
31:03:2014,powerpumpxl,http://goodpreview.info/powerpumpxl,365,365,0
31:03:2014,powerup,http://goodpreview.info/powerup,112,112,0
31:03:2014,premiermangocleanse,http://goodpreview.info/premiermangocleanse,496,496,0
31:03:2014,premiumcleanse,http://goodpreview.info/premiumcleanse,2697,2697,0
31:03:2014,premiumgarciniacambogia,http://goodpreview.info/premiumgarciniacambogia,397,397,0
31:03:2014,premiumgarciniaextract,http://goodpreview.info/premiumgarciniaextract,579,579,0
31:03:2014,premiumgreencoffee,http://goodpreview.info/premiumgreencoffee,118,118,0
31:03:2014,premiumgreencoffee800,http://goodpreview.info/premiumgreencoffee800,107,107,0
31:03:2014,premiumraspberryketone,http://goodpreview.info/premiumraspberryketone,43,43,0
31:03:2014,primalitegarciniaextract,http://goodpreview.info/primalitegarciniaextract,677,677,0
31:03:2014,progain350,http://goodpreview.info/progain350,174,174,0
31:03:2014,prograce,http://goodpreview.info/prograce,1,1,0
31:03:2014,promusclecomplex,http://goodpreview.info/promusclecomplex,48,48,0
31:03:2014,propowercleanse,http://goodpreview.info/propowercleanse,789,789,0
31:03:2014,pureberrymax,http://goodpreview.info/pureberrymax,212,212,0
31:03:2014,purecleansehealth,http://goodpreview.info/purecleansehealth,107,107,0
31:03:2014,purecollagen,http://goodpreview.info/purecollagen,2204,2204,0
31:03:2014,puregarciniacambogia,http://goodpreview.info/puregarciniacambogia,1196,1196,0
31:03:2014,puregarciniaslim,http://goodpreview.info/puregarciniaslim,127,127,0
31:03:2014,puregreencoffeebeanextract,http://goodpreview.info/puregreencoffeebeanextract,2691,2691,0
31:03:2014,puregreencoffeemaxima,http://goodpreview.info/puregreencoffeemaxima,36,36,0
31:03:2014,puregriffonia,http://goodpreview.info/puregriffonia,96,96,0
31:03:2014,pureketoneslim,http://goodpreview.info/pureketoneslim,29,29,0
31:03:2014,purelifeclanse,http://goodpreview.info/purelifeclanse,101,101,0
31:03:2014,puremusclepro,http://goodpreview.info/puremusclepro,1794,1794,0
31:03:2014,purenaturalcleanser,http://goodpreview.info/purenaturalcleanser,476,476,0
31:03:2014,purephytoceramides,http://goodpreview.info/purephytoceramides,68,68,0
31:03:2014,pureraspberryketonepremium,http://goodpreview.info/pureraspberryketonepremium,62,62,0
31:03:2014,puresaffronslim,http://goodpreview.info/puresaffronslim,422,422,0
31:03:2014,pureslim57,http://goodpreview.info/pureslim57,124,124,0
31:03:2014,purgarciniacambogia,http://goodpreview.info/purgarciniacambogia,156,156,0
31:03:2014,purgreencoffee,http://goodpreview.info/purgreencoffee,1622,1622,0
31:03:2014,purifyre,http://goodpreview.info/purifyre,241,241,0
31:03:2014,purifyregreencoffee,http://goodpreview.info/purifyregreencoffee,0,0,0
31:03:2014,raspberryhealth,http://goodpreview.info/raspberryhealth,39,39,0
31:03:2014,raspberryketoneblast,http://goodpreview.info/raspberryketoneblast,3985,3985,0
31:03:2014,raspberryketoned,http://goodpreview.info/raspberryketoned,2,2,0
31:03:2014,raspberryketoneoptimum,http://goodpreview.info/raspberryketoneoptimum,5,5,0
31:03:2014,raspberryketonepremium,http://goodpreview.info/raspberryketonepremium,76,76,0
31:03:2014,raspberryketonepure,http://goodpreview.info/raspberryketonepure,2,2,0
31:03:2014,raspberryketonethin,http://goodpreview.info/raspberryketonethin,401,401,0
31:03:2014,raspberryslimplus,http://goodpreview.info/raspberryslimplus,125,125,0
31:03:2014,refuelextreme,http://goodpreview.info/refuelextreme,452,452,0
31:03:2014,regalecig,http://goodpreview.info/regalecig,352,352,0
31:03:2014,regalecigs,http://goodpreview.info/regalecigs,39,39,0
31:03:2014,rejuvaglow,http://goodpreview.info/rejuvaglow,68,69,-1
31:03:2014,rejuveneyemax,http://goodpreview.info/rejuveneyemax,1,1,0
31:03:2014,rellift,http://goodpreview.info/rellift,29,29,0
31:03:2014,renovo,http://goodpreview.info/renovo,23,23,0
31:03:2014,restiflex,http://goodpreview.info/restiflex,62,62,0
31:03:2014,revitalize,http://goodpreview.info/revitalize,24,24,0
31:03:2014,revitatone,http://goodpreview.info/revitatone,8651,8651,0
31:03:2014,revolutionaryraspberryketone,http://goodpreview.info/revolutionaryraspberryketone,65,65,0
31:03:2014,revoreplex,http://goodpreview.info/revoreplex,114,114,0
31:03:2014,revtesttestosterone,http://goodpreview.info/revtesttestosterone,1587,1587,0
31:03:2014,rippedmusclex,http://goodpreview.info/rippedmusclex,154,154,0
31:03:2014,rippedxburn,http://goodpreview.info/rippedxburn,181,181,0
31:03:2014,sacredarganoil,http://goodpreview.info/sacredarganoil,44,44,0
31:03:2014,safercolon,http://goodpreview.info/safercolon,2928,2928,0
31:03:2014,saffronextractpremium,http://goodpreview.info/saffronextractpremium,104,104,0
31:03:2014,saffronextractselect,http://goodpreview.info/saffronextractselect,1337,1337,0
31:03:2014,saffronselect,http://goodpreview.info/saffronselect,71,71,0
31:03:2014,secretgreencoffee,http://goodpreview.info/secretgreencoffee,241,241,0
31:03:2014,simpleantiaging,http://goodpreview.info/simpleantiaging,226,226,0
31:03:2014,simplygarcinia,http://goodpreview.info/simplygarcinia,992,992,0
31:03:2014,skinlift,http://goodpreview.info/skinlift,2141,2141,0
31:03:2014,slendera,http://goodpreview.info/slendera,15,15,0
31:03:2014,slenderagc-1,http://goodpreview.info/slenderagc-1,382,382,0
31:03:2014,slimatrex,http://goodpreview.info/slimatrex,609,609,0
31:03:2014,slimhelper,http://goodpreview.info/slimhelper,244,244,0
31:03:2014,slimher,http://goodpreview.info/slimher,171,171,0
31:03:2014,slimmeryougarcinia,http://goodpreview.info/slimmeryougarcinia,0,0,0
31:03:2014,slimtropical,http://goodpreview.info/slimtropical,794,794,0
31:03:2014,slimtropicalmx,http://goodpreview.info/slimtropicalmx,133,133,0
31:03:2014,slimzenu,http://goodpreview.info/slimzenu,197,197,0
31:03:2014,smokestarecig,http://goodpreview.info/smokestarecig,510,510,0
31:03:2014,solpriaxtreme,http://goodpreview.info/solpriaxtreme,2758,2758,0
31:03:2014,sorepressin,http://goodpreview.info/sorepressin,4,4,0
31:03:2014,speedtrimxs,http://goodpreview.info/speedtrimxs,89,89,0
31:03:2014,splendyr,http://goodpreview.info/splendyr,1271,1271,0
31:03:2014,splendyrantiaging,http://goodpreview.info/splendyrantiaging,51,51,0
31:03:2014,superacaicleanse,http://goodpreview.info/superacaicleanse,19,19,0
31:03:2014,supercleansetotal,http://goodpreview.info/supercleansetotal,52,52,0
31:03:2014,supergreencoffee,http://goodpreview.info/supergreencoffee,10,10,0
31:03:2014,supergreencoffeebean,http://goodpreview.info/supergreencoffeebean,20,20,0
31:03:2014,superiormusclex,http://goodpreview.info/superiormusclex,74,74,0
31:03:2014,superiorvelvet,http://goodpreview.info/superiorvelvet,1,1,0
31:03:2014,superyacon1000,http://goodpreview.info/superyacon1000,17,17,0
31:03:2014,supracleanse350,http://goodpreview.info/supracleanse350,0,0,0
31:03:2014,supragreencoffee,http://goodpreview.info/supragreencoffee,873,873,0
31:03:2014,supragreencoffeebean,http://goodpreview.info/supragreencoffeebean,0,0,0
31:03:2014,surelyyoung,http://goodpreview.info/surelyyoung,26,26,0
31:03:2014,swissrose,http://goodpreview.info/swissrose,336,336,0
31:03:2014,swolekreate,http://goodpreview.info/swolekreate,189,189,0
31:03:2014,syneocell,http://goodpreview.info/syneocell,48,48,0
31:03:2014,t-force,http://goodpreview.info/t-force,168,168,0
31:03:2014,testforcextreme,http://goodpreview.info/testforcextreme,486,486,0
31:03:2014,testoforce,http://goodpreview.info/testoforce,12,12,0
31:03:2014,testorushrx,http://goodpreview.info/testorushrx,37,37,0
31:03:2014,testosteronemax,http://goodpreview.info/testosteronemax,321,321,0
31:03:2014,testoxl,http://goodpreview.info/testoxl,1455,1455,0
31:03:2014,thinmagic,http://goodpreview.info/thinmagic,235,235,0
31:03:2014,thinmagicmax,http://goodpreview.info/thinmagicmax,0,0,0
31:03:2014,thinsport,http://goodpreview.info/thinsport,211,211,0
31:03:2014,titaniumprox,http://goodpreview.info/titaniumprox,0,0,0
31:03:2014,totalbodyfresh,http://goodpreview.info/totalbodyfresh,109,109,0
31:03:2014,trigx2,http://goodpreview.info/trigx2,4,4,0
31:03:2014,trimaleana,http://goodpreview.info/trimaleana,135,135,0
31:03:2014,trimatol,http://goodpreview.info/trimatol,118,118,0
31:03:2014,trimblendgarciniacambogia,http://goodpreview.info/trimblendgarciniacambogia,71,71,0
31:03:2014,triminexgarciniacambogia,http://goodpreview.info/triminexgarciniacambogia,77,77,0
31:03:2014,triminexgreencoffee,http://goodpreview.info/triminexgreencoffee,49,49,0
31:03:2014,tripleeffectseyeserum,http://goodpreview.info/tripleeffectseyeserum,589,589,0
31:03:2014,turboextracut,http://goodpreview.info/turboextracut,155,155,0
31:03:2014,turboshred,http://goodpreview.info/turboshred,100,100,0
31:03:2014,ultimategarcinia,http://goodpreview.info/ultimategarcinia,162,162,0
31:03:2014,ultramaxtestosterone,http://goodpreview.info/ultramaxtestosterone,33,33,0
31:03:2014,ultrapurecoloncleanse,http://goodpreview.info/ultrapurecoloncleanse,348,348,0
31:03:2014,ultraraspberryketone,http://goodpreview.info/ultraraspberryketone,418,418,0
31:03:2014,velora,http://goodpreview.info/velora,22,22,0
31:03:2014,velveskin,http://goodpreview.info/velveskin,7,7,0
31:03:2014,vencleanse,http://goodpreview.info/vencleanse,425,425,0
31:03:2014,viarex,http://goodpreview.info/viarex,587,587,0
31:03:2014,vitalifedetox,http://goodpreview.info/vitalifedetox,253,253,0
31:03:2014,vitalitygreencoffee,http://goodpreview.info/vitalitygreencoffee,84,84,0
31:03:2014,vitamax,http://goodpreview.info/vitamax,22,22,0
31:03:2014,vitolipo,http://goodpreview.info/vitolipo,1113,1113,0
31:03:2014,vydox,http://goodpreview.info/vydox,290,290,0
31:03:2014,wildraspberryketone,http://goodpreview.info/wildraspberryketone,140,141,-1
31:03:2014,wrinklesscream,http://goodpreview.info/wrinklesscream,252,252,0
31:03:2014,xenaslim,http://goodpreview.info/xenaslim,40,40,0
31:03:2014,xengthx1,http://goodpreview.info/xengthx1,29,29,0
31:03:2014,xlerator,http://goodpreview.info/xlerator,0,0,0
31:03:2014,xocigs,http://goodpreview.info/xocigs,60,60,0
31:03:2014,xtgenix,http://goodpreview.info/xtgenix,12913,12913,0
31:03:2014,xtrememusclepro,http://goodpreview.info/xtrememusclepro,604,604,0
31:03:2014,yaconsplash,http://goodpreview.info/yaconsplash,18,18,0
31:03:2014,yaconsyruporiginal,http://goodpreview.info/yaconsyruporiginal,92,92,0
31:03:2014,yaconsyrupsecret,http://goodpreview.info/yaconsyrupsecret,29,29,0
31:03:2014,yoloboost,http://goodpreview.info/yoloboost,135,135,0
31:03:2014,youthkiteyecream,http://goodpreview.info/youthkiteyecream,239,239,0
31:03:2014,11fruits,http://goodpreview.info/11fruits,194,194,0
31:03:2014,1285muscle,http://goodpreview.info/1285muscle,2852,2852,0
31:03:2014,92trimgreencoffee,http://goodpreview.info/92trimgreencoffee,35,35,0
31:03:2014,Americig,http://goodpreview.info/Americig,388,388,0
31:03:2014,Nuvagenic,http://goodpreview.info/Nuvagenic,1087,1087,0
31:03:2014,Prolexin,http://goodpreview.info/Prolexin,678,678,0
31:03:2014,SVELME,http://goodpreview.info/SVELME,788,788,0
31:03:2014,SlimSpray,http://goodpreview.info/SlimSpray,253,253,0
31:03:2014,acaiberryfresh,http://goodpreview.info/acaiberryfresh,95,95,0
31:03:2014,acainatural,http://goodpreview.info/acainatural,132,132,0
31:03:2014,acaiultralean,http://goodpreview.info/acaiultralean,129,129,0
31:03:2014,advancedgarciniacambogia,http://goodpreview.info/advancedgarciniacambogia,881,881,0
31:03:2014,advancedgarciniacambogia-fr,http://goodpreview.info/advancedgarciniacambogia-fr,106,106,0
31:03:2014,advancedgarciniacambogia1,http://goodpreview.info/advancedgarciniacambogia1,11,11,0
31:03:2014,advancedkrealkalyn,http://goodpreview.info/advancedkrealkalyn,145,145,0
31:03:2014,advancedpurecleanse,http://goodpreview.info/advancedpurecleanse,0,0,0
31:03:2014,advancedpurecleanse1,http://goodpreview.info/advancedpurecleanse1,13,13,0
31:03:2014,africanmangoboost,http://goodpreview.info/africanmangoboost,118,118,0
31:03:2014,africanmangoprox,http://goodpreview.info/africanmangoprox,42,42,0
31:03:2014,africanmangopure,http://goodpreview.info/africanmangopure,76,76,0
31:03:2014,aktiveam,http://goodpreview.info/aktiveam,1591,1591,0
31:03:2014,aktivepm,http://goodpreview.info/aktivepm,1969,1969,0
31:03:2014,alphajacked,http://goodpreview.info/alphajacked,769,769,0
31:03:2014,alphamaxplus,http://goodpreview.info/alphamaxplus,10,10,0
31:03:2014,amazing,http://goodpreview.info/amazing,286,286,0
31:03:2014,aminomuscle,http://goodpreview.info/aminomuscle,1176,1176,0
31:03:2014,aminoprime,http://goodpreview.info/aminoprime,106,106,0
31:03:2014,aminoprimexl,http://goodpreview.info/aminoprimexl,273,273,0
31:03:2014,anabolicrx24,http://goodpreview.info/anabolicrx24,16762,16762,0
31:03:2014,anatomyx5,http://goodpreview.info/anatomyx5,3,3,0
31:03:2014,androsolve,http://goodpreview.info/androsolve,1469,1469,0
31:03:2014,androx,http://goodpreview.info/androx,11477,11477,0
31:03:2014,anoradrol,http://goodpreview.info/anoradrol,210,210,0
31:03:2014,auravie,http://goodpreview.info/auravie,104,104,0
31:03:2014,authenticgreencoffee,http://goodpreview.info/authenticgreencoffee,240,240,0
31:03:2014,beaudify,http://goodpreview.info/beaudify,63,63,0
31:03:2014,beautefxbbcream,http://goodpreview.info/beautefxbbcream,2,2,0
31:03:2014,beautynectarcollagen,http://goodpreview.info/beautynectarcollagen,131,131,0
31:03:2014,beddefense,http://goodpreview.info/beddefense,24,24,0
31:03:2014,bellagenix,http://goodpreview.info/bellagenix,138,138,0
31:03:2014,bellalabs,http://goodpreview.info/bellalabs,7,7,0
31:03:2014,bellaplex,http://goodpreview.info/bellaplex,109,109,0
31:03:2014,beriultimatepro,http://goodpreview.info/beriultimatepro,68,68,0
31:03:2014,berrythin,http://goodpreview.info/berrythin,323,323,0
31:03:2014,betaalaninemax,http://goodpreview.info/betaalaninemax,0,0,0
31:03:2014,betaalaninextreme,http://goodpreview.info/betaalaninextreme,14,14,0
31:03:2014,beyondraspberry,http://goodpreview.info/beyondraspberry,74,74,0
31:03:2014,biohealthgarciniacambogia,http://goodpreview.info/biohealthgarciniacambogia,3330,3330,0
31:03:2014,biomelt,http://goodpreview.info/biomelt,293,293,0
31:03:2014,blastxl,http://goodpreview.info/blastxl,144,144,0
31:03:2014,bodycleanseplus,http://goodpreview.info/bodycleanseplus,66,66,0
31:03:2014,bodywrap,http://goodpreview.info/bodywrap,204,204,0
31:03:2014,breakfree,http://goodpreview.info/breakfree,111,111,0
31:03:2014,cambogiatrim,http://goodpreview.info/cambogiatrim,595,595,0
31:03:2014,capsicum,http://goodpreview.info/capsicum,137,137,0
31:03:2014,celebritycleanser,http://goodpreview.info/celebritycleanser,48,48,0
31:03:2014,celebrityraspberry,http://goodpreview.info/celebrityraspberry,134,134,0
31:03:2014,cellanafricanmango,http://goodpreview.info/cellanafricanmango,234,234,0
31:03:2014,cellogicaskin,http://goodpreview.info/cellogicaskin,46,46,0
31:03:2014,centrislim,http://goodpreview.info/centrislim,197,197,0
31:03:2014,certifiedgreencoffee,http://goodpreview.info/certifiedgreencoffee,147,147,0
31:03:2014,certifiedpuregreencoffee,http://goodpreview.info/certifiedpuregreencoffee,19,19,0
31:03:2014,chiocegreencoffee,http://goodpreview.info/chiocegreencoffee,545,545,0
31:03:2014,choicegreencoffee,http://goodpreview.info/choicegreencoffee,329,329,0
31:03:2014,cleansefx,http://goodpreview.info/cleansefx,8749,8749,0
31:03:2014,cleanseplus,http://goodpreview.info/cleanseplus,361,361,0
31:03:2014,cleanseplus1,http://goodpreview.info/cleanseplus1,0,0,0
31:03:2014,cleansepremium,http://goodpreview.info/cleansepremium,15,15,0
31:03:2014,cleansewonder,http://goodpreview.info/cleansewonder,194,194,0
31:03:2014,cleansextrem,http://goodpreview.info/cleansextrem,1629,1629,0
31:03:2014,cleantrim,http://goodpreview.info/cleantrim,225,225,0
31:03:2014,clearcleansepro,http://goodpreview.info/clearcleansepro,105,105,0
31:03:2014,clearsmoke,http://goodpreview.info/clearsmoke,173,173,0
31:03:2014,codered7,http://goodpreview.info/codered7,284,284,0
31:03:2014,coleanse,http://goodpreview.info/coleanse,122,122,0
31:03:2014,collaton,http://goodpreview.info/collaton,88,88,0
31:03:2014,colocleansepro,http://goodpreview.info/colocleansepro,0,0,0
31:03:2014,coloncleansetotal,http://goodpreview.info/coloncleansetotal,11,11,0
31:03:2014,colonpurecleanse,http://goodpreview.info/colonpurecleanse,130,130,0
31:03:2014,colothin,http://goodpreview.info/colothin,986,986,0
31:03:2014,completecoffeecleanse,http://goodpreview.info/completecoffeecleanse,1967,1967,0
31:03:2014,complexiderm,http://goodpreview.info/complexiderm,102,102,0
31:03:2014,corecutter,http://goodpreview.info/corecutter,20,20,0
31:03:2014,csorex,http://goodpreview.info/csorex,172,172,0
31:03:2014,dailyfacelift,http://goodpreview.info/dailyfacelift,90,90,0
31:03:2014,dailyfacestemcelltechnology,http://goodpreview.info/dailyfacestemcelltechnology,189,189,0
31:03:2014,dailypowercleanse,http://goodpreview.info/dailypowercleanse,96,96,0
31:03:2014,deerantlerxtreme,http://goodpreview.info/deerantlerxtreme,128,128,0
31:03:2014,dermarose,http://goodpreview.info/dermarose,112,112,0
31:03:2014,dermaset,http://goodpreview.info/dermaset,46,46,0
31:03:2014,dermpure,http://goodpreview.info/dermpure,80,80,0
31:03:2014,dietgreencoffeebean,http://goodpreview.info/dietgreencoffeebean,304,304,0
31:03:2014,drillpill,http://goodpreview.info/drillpill,451,451,0
31:03:2014,elevategf,http://goodpreview.info/elevategf,171,171,0
31:03:2014,elier,http://goodpreview.info/elier,50,50,0
31:03:2014,elierskincare,http://goodpreview.info/elierskincare,40,40,0
31:03:2014,elitetest360,http://goodpreview.info/elitetest360,385,385,0
31:03:2014,emeraldluxecig,http://goodpreview.info/emeraldluxecig,111,111,0
31:03:2014,enduros,http://goodpreview.info/enduros,942,942,0
31:03:2014,envigra,http://goodpreview.info/envigra,102,102,0
31:03:2014,estrodetox,http://goodpreview.info/estrodetox,92,92,0
31:03:2014,extentxl,http://goodpreview.info/extentxl,171,171,0
31:03:2014,fembalance,http://goodpreview.info/fembalance,17,17,0
31:03:2014,flawlessraspberryketone,http://goodpreview.info/flawlessraspberryketone,72,72,0
31:03:2014,formulat10,http://goodpreview.info/formulat10,1497,1497,0
31:03:2014,garcinaiawow1,http://goodpreview.info/garcinaiawow1,2562,2562,0
31:03:2014,garciniacambogia,http://goodpreview.info/garciniacambogia,1164,1164,0
31:03:2014,garciniacambogia1000,http://goodpreview.info/garciniacambogia1000,61,61,0
31:03:2014,garciniacambogiaelite,http://goodpreview.info/garciniacambogiaelite,5127,5127,0
31:03:2014,garciniacambogiafatbuster,http://goodpreview.info/garciniacambogiafatbuster,89,89,0
31:03:2014,garciniacambogiamax,http://goodpreview.info/garciniacambogiamax,2387,2387,0
31:03:2014,garciniacambogiamiracle,http://goodpreview.info/garciniacambogiamiracle,126,126,0
31:03:2014,garciniacambogiapremium,http://goodpreview.info/garciniacambogiapremium,1074,1074,0
31:03:2014,garciniacambogiapureextract,http://goodpreview.info/garciniacambogiapureextract,139,139,0
31:03:2014,garciniacambogiapureselect,http://goodpreview.info/garciniacambogiapureselect,575,575,0
31:03:2014,garciniacambogiasupreme,http://goodpreview.info/garciniacambogiasupreme,2719,2719,0
31:03:2014,garciniacambogiatoday,http://goodpreview.info/garciniacambogiatoday,108,108,0
31:03:2014,garciniacambogiaultra,http://goodpreview.info/garciniacambogiaultra,348,348,0
31:03:2014,garciniaforte,http://goodpreview.info/garciniaforte,2646,2646,0
31:03:2014,garciniafreetrial,http://goodpreview.info/garciniafreetrial,66,66,0
31:03:2014,garciniagreen,http://goodpreview.info/garciniagreen,826,826,0
31:03:2014,garciniapureelite1,http://goodpreview.info/garciniapureelite1,1,1,0
31:03:2014,garciniatoday,http://goodpreview.info/garciniatoday,0,0,0
31:03:2014,garciniatotal,http://goodpreview.info/garciniatotal,77,77,0
31:03:2014,garciniawow,http://goodpreview.info/garciniawow,661,661,0
31:03:2014,garcinium,http://goodpreview.info/garcinium,84,84,0
31:03:2014,gc7x,http://goodpreview.info/gc7x,101,101,0
31:03:2014,gc7xgreencoffee,http://goodpreview.info/gc7xgreencoffee,0,0,0
31:03:2014,gcbultra,http://goodpreview.info/gcbultra,51,51,0
31:03:2014,gcbx,http://goodpreview.info/gcbx,17060,17060,0
31:03:2014,gcbx1,http://goodpreview.info/gcbx1,195,195,0
31:03:2014,gcspeedslim,http://goodpreview.info/gcspeedslim,5598,5598,0
31:03:2014,gcultra,http://goodpreview.info/gcultra,132,132,0
31:03:2014,gcultragarcinia,http://goodpreview.info/gcultragarcinia,4,4,0
31:03:2014,geneme,http://goodpreview.info/geneme,39,39,0
31:03:2014,getnaturalgarcinia,http://goodpreview.info/getnaturalgarcinia,40,40,0
31:03:2014,greencoffeeadvanced,http://goodpreview.info/greencoffeeadvanced,180,180,0
31:03:2014,greencoffeebean8000,http://goodpreview.info/greencoffeebean8000,66,66,0
31:03:2014,greencoffeebody,http://goodpreview.info/greencoffeebody,33,33,0
31:03:2014,greencoffeeburn,http://goodpreview.info/greencoffeeburn,22,22,0
31:03:2014,greencoffeeextreme,http://goodpreview.info/greencoffeeextreme,84,84,0
31:03:2014,greencoffeemax,http://goodpreview.info/greencoffeemax,123,123,0
31:03:2014,greencoffeemaxx,http://goodpreview.info/greencoffeemaxx,2,2,0
31:03:2014,greencoffeeoptimum,http://goodpreview.info/greencoffeeoptimum,122,122,0
31:03:2014,greencoffeeprogram,http://goodpreview.info/greencoffeeprogram,0,0,0
31:03:2014,greencoffeeultraslim,http://goodpreview.info/greencoffeeultraslim,201,201,0
31:03:2014,greentonepro,http://goodpreview.info/greentonepro,306,306,0
31:03:2014,healthetrimgarcinia,http://goodpreview.info/healthetrimgarcinia,148,148,0
31:03:2014,healthychoicegc,http://goodpreview.info/healthychoicegc,733,733,0
31:03:2014,horsepowerplusxxxl,http://goodpreview.info/horsepowerplusxxxl,86,86,0
31:03:2014,hugegenic,http://goodpreview.info/hugegenic,250,250,0
31:03:2014,hydrellatone,http://goodpreview.info/hydrellatone,102,102,0
31:03:2014,hydrocollagen,http://goodpreview.info/hydrocollagen,42,42,0
31:03:2014,hydroderm,http://goodpreview.info/hydroderm,43,43,0
31:03:2014,hyperfuel9x,http://goodpreview.info/hyperfuel9x,1874,1874,0
31:03:2014,illuminatedteeth,http://goodpreview.info/illuminatedteeth,31,31,0
31:03:2014,instantwrinklerepair,http://goodpreview.info/instantwrinklerepair,18,18,0
31:03:2014,iqderma,http://goodpreview.info/iqderma,399,399,0
31:03:2014,iqdermaessen,http://goodpreview.info/iqdermaessen,0,0,0
31:03:2014,ketoneoptimum,http://goodpreview.info/ketoneoptimum,150,150,0
31:03:2014,kleanslim,http://goodpreview.info/kleanslim,98,98,0
31:03:2014,lacreme,http://goodpreview.info/lacreme,730,730,0
31:03:2014,leanmuscleformula,http://goodpreview.info/leanmuscleformula,1357,1357,0
31:03:2014,ledermeluxe,http://goodpreview.info/ledermeluxe,184,184,0
31:03:2014,leparfait,http://goodpreview.info/leparfait,6,6,0
31:03:2014,leparisehydragold,http://goodpreview.info/leparisehydragold,58,58,0
31:03:2014,levela,http://goodpreview.info/levela,102,102,0
31:03:2014,lifedetox,http://goodpreview.info/lifedetox,144,144,0
31:03:2014,liftserumpro,http://goodpreview.info/liftserumpro,179,179,0
31:03:2014,liposlender,http://goodpreview.info/liposlender,22,22,0
31:03:2014,liposlim,http://goodpreview.info/liposlim,1829,1829,0
31:03:2014,liposom,http://goodpreview.info/liposom,60,60,0
31:03:2014,liveskinny,http://goodpreview.info/liveskinny,232,232,0
31:03:2014,lumahydrate,http://goodpreview.info/lumahydrate,322,322,0
31:03:2014,lumarepair,http://goodpreview.info/lumarepair,438,438,0
31:03:2014,lunathin,http://goodpreview.info/lunathin,121,121,0
31:03:2014,luxoderm,http://goodpreview.info/luxoderm,180,180,0
31:03:2014,lysocleanse,http://goodpreview.info/lysocleanse,1698,1698,0
31:03:2014,maxdetoxpro,http://goodpreview.info/maxdetoxpro,568,568,0
31:03:2014,maxgarciniaburn,http://goodpreview.info/maxgarciniaburn,455,455,0
31:03:2014,maximumshred,http://goodpreview.info/maximumshred,1497,1497,0
31:03:2014,maxrobust,http://goodpreview.info/maxrobust,244,244,0
31:03:2014,maxrobustxtreme,http://goodpreview.info/maxrobustxtreme,520,520,0
31:03:2014,mightyraspberryketone,http://goodpreview.info/mightyraspberryketone,5081,5081,0
31:03:2014,miraclegarciniacambogia,http://goodpreview.info/miraclegarciniacambogia,440,440,0
31:03:2014,miraclegreencoffee,http://goodpreview.info/miraclegreencoffee,426,426,0
31:03:2014,miraclesaffron,http://goodpreview.info/miraclesaffron,40,40,0
31:03:2014,mitoslim,http://goodpreview.info/mitoslim,2050,2050,0
31:03:2014,musclefactorx,http://goodpreview.info/musclefactorx,1423,1423,0
31:03:2014,musclefactorx-1,http://goodpreview.info/musclefactorx-1,20,20,0
31:03:2014,musclekingpro,http://goodpreview.info/musclekingpro,497,497,0
31:03:2014,musclemaxextreme,http://goodpreview.info/musclemaxextreme,136,136,0
31:03:2014,muscleplus,http://goodpreview.info/muscleplus,138,138,0
31:03:2014,musclerevolutionpro,http://goodpreview.info/musclerevolutionpro,1385,1385,0
31:03:2014,musclerevx,http://goodpreview.info/musclerevx,71,71,0
31:03:2014,musclerevxtreme,http://goodpreview.info/musclerevxtreme,55,55,0
31:03:2014,musclexlerator,http://goodpreview.info/musclexlerator,18,18,0
31:03:2014,musclexmax,http://goodpreview.info/musclexmax,1358,1358,0
31:03:2014,musclexmax1,http://goodpreview.info/musclexmax1,270,270,0
31:03:2014,musclezx90,http://goodpreview.info/musclezx90,4918,4918,0
31:03:2014,naturalcleanse,http://goodpreview.info/naturalcleanse,7950,7950,0
31:03:2014,naturalgarciniacambogia,http://goodpreview.info/naturalgarciniacambogia,2739,2739,0
31:03:2014,naturalgreencoffee,http://goodpreview.info/naturalgreencoffee,7,7,0
31:03:2014,naturalhealthgarcinia,http://goodpreview.info/naturalhealthgarcinia,47,47,0
31:03:2014,naturalpurecleanse,http://goodpreview.info/naturalpurecleanse,1501,1501,0
31:03:2014,nauseam,http://goodpreview.info/nauseam,133,133,0
31:03:2014,nauseamplus,http://goodpreview.info/nauseamplus,0,0,0
31:03:2014,nextrim,http://goodpreview.info/nextrim,1712,1712,0
31:03:2014,nitricmusclemax,http://goodpreview.info/nitricmusclemax,12715,12715,0
31:03:2014,nitrofocusno3,http://goodpreview.info/nitrofocusno3,45,45,0
31:03:2014,niwali,http://goodpreview.info/niwali,780,780,0
31:03:2014,no2explodeextreme,http://goodpreview.info/no2explodeextreme,158,158,0
31:03:2014,no2extremerush,http://goodpreview.info/no2extremerush,1296,1296,0
31:03:2014,noflameecigs,http://goodpreview.info/noflameecigs,350,350,0
31:03:2014,nuclearno,http://goodpreview.info/nuclearno,363,363,0
31:03:2014,nuetrim,http://goodpreview.info/nuetrim,656,656,0
31:03:2014,nutragreencoffee,http://goodpreview.info/nutragreencoffee,3492,3492,0
31:03:2014,nutrapuregarcinia,http://goodpreview.info/nutrapuregarcinia,201,201,0
31:03:2014,nutratoneplus,http://goodpreview.info/nutratoneplus,955,955,0
31:03:2014,nutriberryslim,http://goodpreview.info/nutriberryslim,999,999,0
31:03:2014,nuvoryn,http://goodpreview.info/nuvoryn,22,22,0
31:03:2014,optimalstack,http://goodpreview.info/optimalstack,1617,1617,0
31:03:2014,optimummuscle,http://goodpreview.info/optimummuscle,198,198,0
31:03:2014,organicgreencoffee,http://goodpreview.info/organicgreencoffee,88,88,0
31:03:2014,organicwhitekidneybean,http://goodpreview.info/organicwhitekidneybean,89,89,0
31:03:2014,orviax,http://goodpreview.info/orviax,88,88,0
31:03:2014,oxitamin,http://goodpreview.info/oxitamin,146,146,0
31:03:2014,phtytoceramides,http://goodpreview.info/phtytoceramides,781,781,0
31:03:2014,powerigf,http://goodpreview.info/powerigf,1664,1664,0
31:03:2014,powerpumpxl,http://goodpreview.info/powerpumpxl,365,365,0
31:03:2014,powerup,http://goodpreview.info/powerup,112,112,0
31:03:2014,premiermangocleanse,http://goodpreview.info/premiermangocleanse,496,496,0
31:03:2014,premiumcleanse,http://goodpreview.info/premiumcleanse,2697,2697,0
31:03:2014,premiumgarciniacambogia,http://goodpreview.info/premiumgarciniacambogia,397,397,0
31:03:2014,premiumgarciniaextract,http://goodpreview.info/premiumgarciniaextract,579,579,0
31:03:2014,premiumgreencoffee,http://goodpreview.info/premiumgreencoffee,118,118,0
31:03:2014,premiumgreencoffee800,http://goodpreview.info/premiumgreencoffee800,107,107,0
31:03:2014,premiumraspberryketone,http://goodpreview.info/premiumraspberryketone,43,43,0
31:03:2014,primalitegarciniaextract,http://goodpreview.info/primalitegarciniaextract,677,677,0
31:03:2014,progain350,http://goodpreview.info/progain350,174,174,0
31:03:2014,prograce,http://goodpreview.info/prograce,1,1,0
31:03:2014,promusclecomplex,http://goodpreview.info/promusclecomplex,48,48,0
31:03:2014,propowercleanse,http://goodpreview.info/propowercleanse,789,789,0
31:03:2014,pureberrymax,http://goodpreview.info/pureberrymax,212,212,0
31:03:2014,purecleansehealth,http://goodpreview.info/purecleansehealth,107,107,0
31:03:2014,purecollagen,http://goodpreview.info/purecollagen,2204,2204,0
31:03:2014,puregarciniacambogia,http://goodpreview.info/puregarciniacambogia,1196,1196,0
31:03:2014,puregarciniaslim,http://goodpreview.info/puregarciniaslim,127,127,0
31:03:2014,puregreencoffeebeanextract,http://goodpreview.info/puregreencoffeebeanextract,2691,2691,0
31:03:2014,puregreencoffeemaxima,http://goodpreview.info/puregreencoffeemaxima,36,36,0
31:03:2014,puregriffonia,http://goodpreview.info/puregriffonia,96,96,0
31:03:2014,pureketoneslim,http://goodpreview.info/pureketoneslim,29,29,0
31:03:2014,purelifeclanse,http://goodpreview.info/purelifeclanse,101,101,0
31:03:2014,puremusclepro,http://goodpreview.info/puremusclepro,1794,1794,0
31:03:2014,purenaturalcleanser,http://goodpreview.info/purenaturalcleanser,476,476,0
31:03:2014,purephytoceramides,http://goodpreview.info/purephytoceramides,68,68,0
31:03:2014,pureraspberryketonepremium,http://goodpreview.info/pureraspberryketonepremium,62,62,0
31:03:2014,puresaffronslim,http://goodpreview.info/puresaffronslim,422,422,0
31:03:2014,pureslim57,http://goodpreview.info/pureslim57,124,124,0
31:03:2014,purgarciniacambogia,http://goodpreview.info/purgarciniacambogia,156,156,0
31:03:2014,purgreencoffee,http://goodpreview.info/purgreencoffee,1622,1622,0
31:03:2014,purifyre,http://goodpreview.info/purifyre,241,241,0
31:03:2014,purifyregreencoffee,http://goodpreview.info/purifyregreencoffee,0,0,0
31:03:2014,raspberryhealth,http://goodpreview.info/raspberryhealth,39,39,0
31:03:2014,raspberryketoneblast,http://goodpreview.info/raspberryketoneblast,3985,3985,0
31:03:2014,raspberryketoned,http://goodpreview.info/raspberryketoned,2,2,0
31:03:2014,raspberryketoneoptimum,http://goodpreview.info/raspberryketoneoptimum,5,5,0
31:03:2014,raspberryketonepremium,http://goodpreview.info/raspberryketonepremium,76,76,0
31:03:2014,raspberryketonepure,http://goodpreview.info/raspberryketonepure,2,2,0
31:03:2014,raspberryketonethin,http://goodpreview.info/raspberryketonethin,401,401,0
31:03:2014,raspberryslimplus,http://goodpreview.info/raspberryslimplus,125,125,0
31:03:2014,refuelextreme,http://goodpreview.info/refuelextreme,452,452,0
31:03:2014,regalecig,http://goodpreview.info/regalecig,352,352,0
31:03:2014,regalecigs,http://goodpreview.info/regalecigs,39,39,0
31:03:2014,rejuvaglow,http://goodpreview.info/rejuvaglow,69,69,0
31:03:2014,rejuveneyemax,http://goodpreview.info/rejuveneyemax,1,1,0
31:03:2014,rellift,http://goodpreview.info/rellift,29,29,0
31:03:2014,renovo,http://goodpreview.info/renovo,23,23,0
31:03:2014,restiflex,http://goodpreview.info/restiflex,62,62,0
31:03:2014,revitalize,http://goodpreview.info/revitalize,24,24,0
31:03:2014,revitatone,http://goodpreview.info/revitatone,8651,8652,-1
31:03:2014,revolutionaryraspberryketone,http://goodpreview.info/revolutionaryraspberryketone,65,65,0
31:03:2014,revoreplex,http://goodpreview.info/revoreplex,114,114,0
31:03:2014,revtesttestosterone,http://goodpreview.info/revtesttestosterone,1587,1587,0
31:03:2014,rippedmusclex,http://goodpreview.info/rippedmusclex,154,154,0
31:03:2014,rippedxburn,http://goodpreview.info/rippedxburn,181,181,0
31:03:2014,sacredarganoil,http://goodpreview.info/sacredarganoil,44,44,0
31:03:2014,safercolon,http://goodpreview.info/safercolon,2928,2928,0
31:03:2014,saffronextractpremium,http://goodpreview.info/saffronextractpremium,104,104,0
31:03:2014,saffronextractselect,http://goodpreview.info/saffronextractselect,1337,1337,0
31:03:2014,saffronselect,http://goodpreview.info/saffronselect,71,71,0
31:03:2014,secretgreencoffee,http://goodpreview.info/secretgreencoffee,241,241,0
31:03:2014,simpleantiaging,http://goodpreview.info/simpleantiaging,226,226,0
31:03:2014,simplygarcinia,http://goodpreview.info/simplygarcinia,992,992,0
31:03:2014,skinlift,http://goodpreview.info/skinlift,2141,2141,0
31:03:2014,slendera,http://goodpreview.info/slendera,15,15,0
31:03:2014,slenderagc-1,http://goodpreview.info/slenderagc-1,382,382,0
31:03:2014,slimatrex,http://goodpreview.info/slimatrex,609,609,0
31:03:2014,slimhelper,http://goodpreview.info/slimhelper,244,244,0
31:03:2014,slimher,http://goodpreview.info/slimher,171,171,0
31:03:2014,slimmeryougarcinia,http://goodpreview.info/slimmeryougarcinia,0,0,0
31:03:2014,slimtropical,http://goodpreview.info/slimtropical,794,794,0
31:03:2014,slimtropicalmx,http://goodpreview.info/slimtropicalmx,133,133,0
31:03:2014,slimzenu,http://goodpreview.info/slimzenu,197,197,0
31:03:2014,smokestarecig,http://goodpreview.info/smokestarecig,510,510,0
31:03:2014,solpriaxtreme,http://goodpreview.info/solpriaxtreme,2758,2758,0
31:03:2014,sorepressin,http://goodpreview.info/sorepressin,4,4,0
31:03:2014,speedtrimxs,http://goodpreview.info/speedtrimxs,89,89,0
31:03:2014,splendyr,http://goodpreview.info/splendyr,1271,1271,0
31:03:2014,splendyrantiaging,http://goodpreview.info/splendyrantiaging,51,51,0
31:03:2014,superacaicleanse,http://goodpreview.info/superacaicleanse,19,19,0
31:03:2014,supercleansetotal,http://goodpreview.info/supercleansetotal,52,52,0
31:03:2014,supergreencoffee,http://goodpreview.info/supergreencoffee,10,10,0
31:03:2014,supergreencoffeebean,http://goodpreview.info/supergreencoffeebean,20,20,0
31:03:2014,superiormusclex,http://goodpreview.info/superiormusclex,74,74,0
31:03:2014,superiorvelvet,http://goodpreview.info/superiorvelvet,1,1,0
31:03:2014,superyacon1000,http://goodpreview.info/superyacon1000,17,17,0
31:03:2014,supracleanse350,http://goodpreview.info/supracleanse350,0,0,0
31:03:2014,supragreencoffee,http://goodpreview.info/supragreencoffee,873,873,0
31:03:2014,supragreencoffeebean,http://goodpreview.info/supragreencoffeebean,0,0,0
31:03:2014,surelyyoung,http://goodpreview.info/surelyyoung,26,26,0
31:03:2014,swissrose,http://goodpreview.info/swissrose,336,336,0
31:03:2014,swolekreate,http://goodpreview.info/swolekreate,189,189,0
31:03:2014,syneocell,http://goodpreview.info/syneocell,48,48,0
31:03:2014,t-force,http://goodpreview.info/t-force,168,168,0
31:03:2014,testforcextreme,http://goodpreview.info/testforcextreme,486,486,0
31:03:2014,testoforce,http://goodpreview.info/testoforce,12,12,0
31:03:2014,testorushrx,http://goodpreview.info/testorushrx,37,37,0
31:03:2014,testosteronemax,http://goodpreview.info/testosteronemax,321,321,0
31:03:2014,testoxl,http://goodpreview.info/testoxl,1455,1455,0
31:03:2014,thinmagic,http://goodpreview.info/thinmagic,235,235,0
31:03:2014,thinmagicmax,http://goodpreview.info/thinmagicmax,0,0,0
31:03:2014,thinsport,http://goodpreview.info/thinsport,211,211,0
31:03:2014,titaniumprox,http://goodpreview.info/titaniumprox,0,0,0
31:03:2014,totalbodyfresh,http://goodpreview.info/totalbodyfresh,109,109,0
31:03:2014,trigx2,http://goodpreview.info/trigx2,4,4,0
31:03:2014,trimaleana,http://goodpreview.info/trimaleana,135,135,0
31:03:2014,trimatol,http://goodpreview.info/trimatol,118,118,0
31:03:2014,trimblendgarciniacambogia,http://goodpreview.info/trimblendgarciniacambogia,71,71,0
31:03:2014,triminexgarciniacambogia,http://goodpreview.info/triminexgarciniacambogia,77,77,0
31:03:2014,triminexgreencoffee,http://goodpreview.info/triminexgreencoffee,49,49,0
31:03:2014,tripleeffectseyeserum,http://goodpreview.info/tripleeffectseyeserum,589,589,0
31:03:2014,turboextracut,http://goodpreview.info/turboextracut,155,155,0
31:03:2014,turboshred,http://goodpreview.info/turboshred,100,100,0
31:03:2014,ultimategarcinia,http://goodpreview.info/ultimategarcinia,162,162,0
31:03:2014,ultramaxtestosterone,http://goodpreview.info/ultramaxtestosterone,33,33,0
31:03:2014,ultrapurecoloncleanse,http://goodpreview.info/ultrapurecoloncleanse,348,348,0
31:03:2014,ultraraspberryketone,http://goodpreview.info/ultraraspberryketone,418,418,0
31:03:2014,velora,http://goodpreview.info/velora,22,22,0
31:03:2014,velveskin,http://goodpreview.info/velveskin,7,7,0
31:03:2014,vencleanse,http://goodpreview.info/vencleanse,425,425,0
31:03:2014,viarex,http://goodpreview.info/viarex,587,587,0
31:03:2014,vitalifedetox,http://goodpreview.info/vitalifedetox,253,253,0
31:03:2014,vitalitygreencoffee,http://goodpreview.info/vitalitygreencoffee,84,84,0
31:03:2014,vitamax,http://goodpreview.info/vitamax,22,22,0
31:03:2014,vitolipo,http://goodpreview.info/vitolipo,1113,1113,0
31:03:2014,vydox,http://goodpreview.info/vydox,290,290,0
31:03:2014,wildraspberryketone,http://goodpreview.info/wildraspberryketone,141,141,0
31:03:2014,wrinklesscream,http://goodpreview.info/wrinklesscream,252,252,0
31:03:2014,xenaslim,http://goodpreview.info/xenaslim,40,40,0
31:03:2014,xengthx1,http://goodpreview.info/xengthx1,29,29,0
31:03:2014,xlerator,http://goodpreview.info/xlerator,0,0,0
31:03:2014,xocigs,http://goodpreview.info/xocigs,60,60,0
31:03:2014,xtgenix,http://goodpreview.info/xtgenix,12913,12913,0
31:03:2014,xtrememusclepro,http://goodpreview.info/xtrememusclepro,604,604,0
31:03:2014,yaconsplash,http://goodpreview.info/yaconsplash,18,18,0
31:03:2014,yaconsyruporiginal,http://goodpreview.info/yaconsyruporiginal,92,92,0
31:03:2014,yaconsyrupsecret,http://goodpreview.info/yaconsyrupsecret,29,29,0
31:03:2014,yoloboost,http://goodpreview.info/yoloboost,135,135,0
31:03:2014,youthkiteyecream,http://goodpreview.info/youthkiteyecream,239,239,0
31:03:2014,11fruits,http://goodpreview.info/11fruits,194,194,0
31:03:2014,1285muscle,http://goodpreview.info/1285muscle,2852,2852,0
31:03:2014,92trimgreencoffee,http://goodpreview.info/92trimgreencoffee,35,35,0
31:03:2014,Americig,http://goodpreview.info/Americig,388,388,0
31:03:2014,Nuvagenic,http://goodpreview.info/Nuvagenic,1087,1088,-1
31:03:2014,Prolexin,http://goodpreview.info/Prolexin,678,678,0
31:03:2014,SVELME,http://goodpreview.info/SVELME,788,788,0
31:03:2014,SlimSpray,http://goodpreview.info/SlimSpray,253,253,0
31:03:2014,acaiberryfresh,http://goodpreview.info/acaiberryfresh,95,95,0
31:03:2014,acainatural,http://goodpreview.info/acainatural,132,132,0
31:03:2014,acaiultralean,http://goodpreview.info/acaiultralean,129,129,0
31:03:2014,advancedgarciniacambogia,http://goodpreview.info/advancedgarciniacambogia,881,881,0
31:03:2014,advancedgarciniacambogia-fr,http://goodpreview.info/advancedgarciniacambogia-fr,106,106,0
31:03:2014,advancedgarciniacambogia1,http://goodpreview.info/advancedgarciniacambogia1,11,11,0
31:03:2014,advancedkrealkalyn,http://goodpreview.info/advancedkrealkalyn,145,145,0
31:03:2014,advancedpurecleanse,http://goodpreview.info/advancedpurecleanse,0,0,0
31:03:2014,advancedpurecleanse1,http://goodpreview.info/advancedpurecleanse1,13,13,0
31:03:2014,africanmangoboost,http://goodpreview.info/africanmangoboost,118,118,0
31:03:2014,africanmangoprox,http://goodpreview.info/africanmangoprox,42,42,0
31:03:2014,africanmangopure,http://goodpreview.info/africanmangopure,76,76,0
31:03:2014,aktiveam,http://goodpreview.info/aktiveam,1591,1591,0
31:03:2014,aktivepm,http://goodpreview.info/aktivepm,1969,1969,0
31:03:2014,alphajacked,http://goodpreview.info/alphajacked,769,769,0
31:03:2014,alphamaxplus,http://goodpreview.info/alphamaxplus,10,10,0
31:03:2014,amazing,http://goodpreview.info/amazing,286,286,0
31:03:2014,aminomuscle,http://goodpreview.info/aminomuscle,1176,1176,0
31:03:2014,aminoprime,http://goodpreview.info/aminoprime,106,106,0
31:03:2014,aminoprimexl,http://goodpreview.info/aminoprimexl,273,273,0
31:03:2014,anabolicrx24,http://goodpreview.info/anabolicrx24,16762,16762,0
31:03:2014,anatomyx5,http://goodpreview.info/anatomyx5,3,3,0
31:03:2014,androsolve,http://goodpreview.info/androsolve,1469,1469,0
31:03:2014,androx,http://goodpreview.info/androx,11477,11477,0
31:03:2014,anoradrol,http://goodpreview.info/anoradrol,210,210,0
31:03:2014,auravie,http://goodpreview.info/auravie,104,104,0
31:03:2014,authenticgreencoffee,http://goodpreview.info/authenticgreencoffee,240,240,0
31:03:2014,beaudify,http://goodpreview.info/beaudify,63,64,-1
31:03:2014,beautefxbbcream,http://goodpreview.info/beautefxbbcream,2,2,0
31:03:2014,beautynectarcollagen,http://goodpreview.info/beautynectarcollagen,131,131,0
31:03:2014,beddefense,http://goodpreview.info/beddefense,24,24,0
31:03:2014,bellagenix,http://goodpreview.info/bellagenix,138,138,0
31:03:2014,bellalabs,http://goodpreview.info/bellalabs,7,7,0
31:03:2014,bellaplex,http://goodpreview.info/bellaplex,109,109,0
31:03:2014,beriultimatepro,http://goodpreview.info/beriultimatepro,68,68,0
31:03:2014,berrythin,http://goodpreview.info/berrythin,323,323,0
31:03:2014,betaalaninemax,http://goodpreview.info/betaalaninemax,0,0,0
31:03:2014,betaalaninextreme,http://goodpreview.info/betaalaninextreme,14,14,0
31:03:2014,beyondraspberry,http://goodpreview.info/beyondraspberry,74,74,0
31:03:2014,biohealthgarciniacambogia,http://goodpreview.info/biohealthgarciniacambogia,3330,3330,0
31:03:2014,biomelt,http://goodpreview.info/biomelt,293,293,0
31:03:2014,blastxl,http://goodpreview.info/blastxl,144,144,0
31:03:2014,bodycleanseplus,http://goodpreview.info/bodycleanseplus,66,66,0
31:03:2014,bodywrap,http://goodpreview.info/bodywrap,204,204,0
31:03:2014,breakfree,http://goodpreview.info/breakfree,111,111,0
31:03:2014,cambogiatrim,http://goodpreview.info/cambogiatrim,595,596,-1
31:03:2014,capsicum,http://goodpreview.info/capsicum,137,137,0
31:03:2014,celebritycleanser,http://goodpreview.info/celebritycleanser,48,48,0
31:03:2014,celebrityraspberry,http://goodpreview.info/celebrityraspberry,134,134,0
31:03:2014,cellanafricanmango,http://goodpreview.info/cellanafricanmango,234,234,0
31:03:2014,cellogicaskin,http://goodpreview.info/cellogicaskin,46,46,0
31:03:2014,centrislim,http://goodpreview.info/centrislim,197,197,0
31:03:2014,certifiedgreencoffee,http://goodpreview.info/certifiedgreencoffee,147,147,0
31:03:2014,certifiedpuregreencoffee,http://goodpreview.info/certifiedpuregreencoffee,19,19,0
31:03:2014,chiocegreencoffee,http://goodpreview.info/chiocegreencoffee,545,545,0
31:03:2014,choicegreencoffee,http://goodpreview.info/choicegreencoffee,329,329,0
31:03:2014,cleansefx,http://goodpreview.info/cleansefx,8749,8749,0
31:03:2014,cleanseplus,http://goodpreview.info/cleanseplus,361,361,0
31:03:2014,cleanseplus1,http://goodpreview.info/cleanseplus1,0,0,0
31:03:2014,cleansepremium,http://goodpreview.info/cleansepremium,15,15,0
31:03:2014,cleansewonder,http://goodpreview.info/cleansewonder,194,194,0
31:03:2014,cleansextrem,http://goodpreview.info/cleansextrem,1629,1629,0
31:03:2014,cleantrim,http://goodpreview.info/cleantrim,225,225,0
31:03:2014,clearcleansepro,http://goodpreview.info/clearcleansepro,105,105,0
31:03:2014,clearsmoke,http://goodpreview.info/clearsmoke,173,173,0
31:03:2014,codered7,http://goodpreview.info/codered7,284,284,0
31:03:2014,coleanse,http://goodpreview.info/coleanse,122,122,0
31:03:2014,collaton,http://goodpreview.info/collaton,88,88,0
31:03:2014,colocleansepro,http://goodpreview.info/colocleansepro,0,0,0
31:03:2014,coloncleansetotal,http://goodpreview.info/coloncleansetotal,11,12,-1
31:03:2014,colonpurecleanse,http://goodpreview.info/colonpurecleanse,130,130,0
31:03:2014,colothin,http://goodpreview.info/colothin,986,986,0
31:03:2014,completecoffeecleanse,http://goodpreview.info/completecoffeecleanse,1967,1967,0
31:03:2014,complexiderm,http://goodpreview.info/complexiderm,102,102,0
31:03:2014,corecutter,http://goodpreview.info/corecutter,20,20,0
31:03:2014,csorex,http://goodpreview.info/csorex,172,172,0
31:03:2014,dailyfacelift,http://goodpreview.info/dailyfacelift,90,90,0
31:03:2014,dailyfacestemcelltechnology,http://goodpreview.info/dailyfacestemcelltechnology,189,189,0
31:03:2014,dailypowercleanse,http://goodpreview.info/dailypowercleanse,96,96,0
31:03:2014,deerantlerxtreme,http://goodpreview.info/deerantlerxtreme,128,128,0
31:03:2014,dermarose,http://goodpreview.info/dermarose,112,112,0
31:03:2014,dermaset,http://goodpreview.info/dermaset,46,46,0
31:03:2014,dermpure,http://goodpreview.info/dermpure,80,80,0
31:03:2014,dietgreencoffeebean,http://goodpreview.info/dietgreencoffeebean,304,304,0
31:03:2014,drillpill,http://goodpreview.info/drillpill,451,451,0
31:03:2014,elevategf,http://goodpreview.info/elevategf,171,171,0
31:03:2014,elier,http://goodpreview.info/elier,50,50,0
31:03:2014,elierskincare,http://goodpreview.info/elierskincare,40,40,0
31:03:2014,elitetest360,http://goodpreview.info/elitetest360,385,385,0
31:03:2014,emeraldluxecig,http://goodpreview.info/emeraldluxecig,111,111,0
31:03:2014,enduros,http://goodpreview.info/enduros,942,942,0
31:03:2014,envigra,http://goodpreview.info/envigra,102,102,0
31:03:2014,estrodetox,http://goodpreview.info/estrodetox,92,92,0
31:03:2014,extentxl,http://goodpreview.info/extentxl,171,171,0
31:03:2014,fembalance,http://goodpreview.info/fembalance,17,17,0
31:03:2014,flawlessraspberryketone,http://goodpreview.info/flawlessraspberryketone,72,72,0
31:03:2014,formulat10,http://goodpreview.info/formulat10,1497,1497,0
31:03:2014,garcinaiawow1,http://goodpreview.info/garcinaiawow1,2562,2562,0
31:03:2014,garciniacambogia,http://goodpreview.info/garciniacambogia,1164,1165,-1
31:03:2014,garciniacambogia1000,http://goodpreview.info/garciniacambogia1000,61,61,0
31:03:2014,garciniacambogiaelite,http://goodpreview.info/garciniacambogiaelite,5127,5127,0
31:03:2014,garciniacambogiafatbuster,http://goodpreview.info/garciniacambogiafatbuster,89,89,0
31:03:2014,garciniacambogiamax,http://goodpreview.info/garciniacambogiamax,2387,2387,0
31:03:2014,garciniacambogiamiracle,http://goodpreview.info/garciniacambogiamiracle,126,126,0
31:03:2014,garciniacambogiapremium,http://goodpreview.info/garciniacambogiapremium,1074,1075,-1
31:03:2014,garciniacambogiapureextract,http://goodpreview.info/garciniacambogiapureextract,139,139,0
31:03:2014,garciniacambogiapureselect,http://goodpreview.info/garciniacambogiapureselect,575,575,0
31:03:2014,garciniacambogiasupreme,http://goodpreview.info/garciniacambogiasupreme,2719,2720,-1
31:03:2014,garciniacambogiatoday,http://goodpreview.info/garciniacambogiatoday,108,108,0
31:03:2014,garciniacambogiaultra,http://goodpreview.info/garciniacambogiaultra,348,349,-1
31:03:2014,garciniaforte,http://goodpreview.info/garciniaforte,2646,2646,0
31:03:2014,garciniafreetrial,http://goodpreview.info/garciniafreetrial,66,67,-1
31:03:2014,garciniagreen,http://goodpreview.info/garciniagreen,826,826,0
31:03:2014,garciniapureelite1,http://goodpreview.info/garciniapureelite1,1,1,0
31:03:2014,garciniatoday,http://goodpreview.info/garciniatoday,0,0,0
31:03:2014,garciniatotal,http://goodpreview.info/garciniatotal,77,77,0
31:03:2014,garciniawow,http://goodpreview.info/garciniawow,661,661,0
31:03:2014,garcinium,http://goodpreview.info/garcinium,84,84,0
31:03:2014,gc7x,http://goodpreview.info/gc7x,101,101,0
31:03:2014,gc7xgreencoffee,http://goodpreview.info/gc7xgreencoffee,0,0,0
31:03:2014,gcbultra,http://goodpreview.info/gcbultra,51,51,0
31:03:2014,gcbx,http://goodpreview.info/gcbx,17060,17061,-1
31:03:2014,gcbx1,http://goodpreview.info/gcbx1,195,195,0
31:03:2014,gcspeedslim,http://goodpreview.info/gcspeedslim,5598,5598,0
31:03:2014,gcultra,http://goodpreview.info/gcultra,132,133,-1
31:03:2014,gcultragarcinia,http://goodpreview.info/gcultragarcinia,4,4,0
31:03:2014,geneme,http://goodpreview.info/geneme,39,39,0
31:03:2014,getnaturalgarcinia,http://goodpreview.info/getnaturalgarcinia,40,40,0
31:03:2014,greencoffeeadvanced,http://goodpreview.info/greencoffeeadvanced,180,180,0
31:03:2014,greencoffeebean8000,http://goodpreview.info/greencoffeebean8000,66,66,0
31:03:2014,greencoffeebody,http://goodpreview.info/greencoffeebody,33,33,0
31:03:2014,greencoffeeburn,http://goodpreview.info/greencoffeeburn,22,22,0
31:03:2014,greencoffeeextreme,http://goodpreview.info/greencoffeeextreme,84,84,0
31:03:2014,greencoffeemax,http://goodpreview.info/greencoffeemax,123,123,0
31:03:2014,greencoffeemaxx,http://goodpreview.info/greencoffeemaxx,2,2,0
31:03:2014,greencoffeeoptimum,http://goodpreview.info/greencoffeeoptimum,122,122,0
31:03:2014,greencoffeeprogram,http://goodpreview.info/greencoffeeprogram,0,0,0
31:03:2014,greencoffeeultraslim,http://goodpreview.info/greencoffeeultraslim,201,201,0
31:03:2014,greentonepro,http://goodpreview.info/greentonepro,306,306,0
31:03:2014,healthetrimgarcinia,http://goodpreview.info/healthetrimgarcinia,148,148,0
31:03:2014,healthychoicegc,http://goodpreview.info/healthychoicegc,733,733,0
31:03:2014,horsepowerplusxxxl,http://goodpreview.info/horsepowerplusxxxl,86,87,-1
31:03:2014,hugegenic,http://goodpreview.info/hugegenic,250,250,0
31:03:2014,hydrellatone,http://goodpreview.info/hydrellatone,102,102,0
31:03:2014,hydrocollagen,http://goodpreview.info/hydrocollagen,42,42,0
31:03:2014,hydroderm,http://goodpreview.info/hydroderm,43,43,0
31:03:2014,hyperfuel9x,http://goodpreview.info/hyperfuel9x,1874,1874,0
31:03:2014,illuminatedteeth,http://goodpreview.info/illuminatedteeth,31,31,0
31:03:2014,instantwrinklerepair,http://goodpreview.info/instantwrinklerepair,18,18,0
31:03:2014,iqderma,http://goodpreview.info/iqderma,399,399,0
31:03:2014,iqdermaessen,http://goodpreview.info/iqdermaessen,0,0,0
31:03:2014,ketoneoptimum,http://goodpreview.info/ketoneoptimum,150,150,0
31:03:2014,kleanslim,http://goodpreview.info/kleanslim,98,98,0
31:03:2014,lacreme,http://goodpreview.info/lacreme,730,730,0
31:03:2014,leanmuscleformula,http://goodpreview.info/leanmuscleformula,1357,1357,0
31:03:2014,ledermeluxe,http://goodpreview.info/ledermeluxe,184,184,0
31:03:2014,leparfait,http://goodpreview.info/leparfait,6,6,0
31:03:2014,leparisehydragold,http://goodpreview.info/leparisehydragold,58,58,0
31:03:2014,levela,http://goodpreview.info/levela,102,102,0
31:03:2014,lifedetox,http://goodpreview.info/lifedetox,144,145,-1
31:03:2014,liftserumpro,http://goodpreview.info/liftserumpro,179,179,0
31:03:2014,liposlender,http://goodpreview.info/liposlender,22,22,0
31:03:2014,liposlim,http://goodpreview.info/liposlim,1829,1829,0
31:03:2014,liposom,http://goodpreview.info/liposom,60,60,0
31:03:2014,liveskinny,http://goodpreview.info/liveskinny,232,232,0
31:03:2014,lumahydrate,http://goodpreview.info/lumahydrate,322,322,0
31:03:2014,lumarepair,http://goodpreview.info/lumarepair,438,438,0
31:03:2014,lunathin,http://goodpreview.info/lunathin,121,121,0
31:03:2014,luxoderm,http://goodpreview.info/luxoderm,180,180,0
31:03:2014,lysocleanse,http://goodpreview.info/lysocleanse,1698,1698,0
31:03:2014,maxdetoxpro,http://goodpreview.info/maxdetoxpro,568,568,0
31:03:2014,maxgarciniaburn,http://goodpreview.info/maxgarciniaburn,455,455,0
31:03:2014,maximumshred,http://goodpreview.info/maximumshred,1497,1497,0
31:03:2014,maxrobust,http://goodpreview.info/maxrobust,244,244,0
31:03:2014,maxrobustxtreme,http://goodpreview.info/maxrobustxtreme,520,520,0
31:03:2014,mightyraspberryketone,http://goodpreview.info/mightyraspberryketone,5081,5081,0
31:03:2014,miraclegarciniacambogia,http://goodpreview.info/miraclegarciniacambogia,440,441,-1
31:03:2014,miraclegreencoffee,http://goodpreview.info/miraclegreencoffee,426,426,0
31:03:2014,miraclesaffron,http://goodpreview.info/miraclesaffron,40,40,0
31:03:2014,mitoslim,http://goodpreview.info/mitoslim,2050,2050,0
31:03:2014,musclefactorx,http://goodpreview.info/musclefactorx,1423,1423,0
31:03:2014,musclefactorx-1,http://goodpreview.info/musclefactorx-1,20,20,0
31:03:2014,musclekingpro,http://goodpreview.info/musclekingpro,497,497,0
31:03:2014,musclemaxextreme,http://goodpreview.info/musclemaxextreme,136,136,0
31:03:2014,muscleplus,http://goodpreview.info/muscleplus,138,138,0
31:03:2014,musclerevolutionpro,http://goodpreview.info/musclerevolutionpro,1385,1385,0
31:03:2014,musclerevx,http://goodpreview.info/musclerevx,71,71,0
31:03:2014,musclerevxtreme,http://goodpreview.info/musclerevxtreme,55,55,0
31:03:2014,musclexlerator,http://goodpreview.info/musclexlerator,18,18,0
31:03:2014,musclexmax,http://goodpreview.info/musclexmax,1358,1358,0
31:03:2014,musclexmax1,http://goodpreview.info/musclexmax1,270,270,0
31:03:2014,musclezx90,http://goodpreview.info/musclezx90,4918,4918,0
31:03:2014,naturalcleanse,http://goodpreview.info/naturalcleanse,7950,7950,0
31:03:2014,naturalgarciniacambogia,http://goodpreview.info/naturalgarciniacambogia,2739,2739,0
31:03:2014,naturalgreencoffee,http://goodpreview.info/naturalgreencoffee,7,7,0
31:03:2014,naturalhealthgarcinia,http://goodpreview.info/naturalhealthgarcinia,47,47,0
31:03:2014,naturalpurecleanse,http://goodpreview.info/naturalpurecleanse,1501,1501,0
31:03:2014,nauseam,http://goodpreview.info/nauseam,133,133,0
31:03:2014,nauseamplus,http://goodpreview.info/nauseamplus,0,0,0
31:03:2014,nextrim,http://goodpreview.info/nextrim,1712,1712,0
31:03:2014,nitricmusclemax,http://goodpreview.info/nitricmusclemax,12715,12715,0
31:03:2014,nitrofocusno3,http://goodpreview.info/nitrofocusno3,45,45,0
31:03:2014,niwali,http://goodpreview.info/niwali,780,780,0
31:03:2014,no2explodeextreme,http://goodpreview.info/no2explodeextreme,158,158,0
31:03:2014,no2extremerush,http://goodpreview.info/no2extremerush,1296,1296,0
31:03:2014,noflameecigs,http://goodpreview.info/noflameecigs,350,350,0
31:03:2014,nuclearno,http://goodpreview.info/nuclearno,363,363,0
31:03:2014,nuetrim,http://goodpreview.info/nuetrim,656,656,0
31:03:2014,nutragreencoffee,http://goodpreview.info/nutragreencoffee,3492,3492,0
31:03:2014,nutrapuregarcinia,http://goodpreview.info/nutrapuregarcinia,201,201,0
31:03:2014,nutratoneplus,http://goodpreview.info/nutratoneplus,955,955,0
31:03:2014,nutriberryslim,http://goodpreview.info/nutriberryslim,999,1000,-1
31:03:2014,nuvoryn,http://goodpreview.info/nuvoryn,22,22,0
31:03:2014,optimalstack,http://goodpreview.info/optimalstack,1617,1617,0
31:03:2014,optimummuscle,http://goodpreview.info/optimummuscle,198,198,0
31:03:2014,organicgreencoffee,http://goodpreview.info/organicgreencoffee,88,89,-1
31:03:2014,organicwhitekidneybean,http://goodpreview.info/organicwhitekidneybean,89,89,0
31:03:2014,orviax,http://goodpreview.info/orviax,88,88,0
31:03:2014,oxitamin,http://goodpreview.info/oxitamin,146,146,0
31:03:2014,phtytoceramides,http://goodpreview.info/phtytoceramides,781,781,0
31:03:2014,powerigf,http://goodpreview.info/powerigf,1664,1664,0
31:03:2014,powerpumpxl,http://goodpreview.info/powerpumpxl,365,365,0
31:03:2014,powerup,http://goodpreview.info/powerup,112,112,0
31:03:2014,premiermangocleanse,http://goodpreview.info/premiermangocleanse,496,496,0
31:03:2014,premiumcleanse,http://goodpreview.info/premiumcleanse,2697,2697,0
31:03:2014,premiumgarciniacambogia,http://goodpreview.info/premiumgarciniacambogia,397,397,0
31:03:2014,premiumgarciniaextract,http://goodpreview.info/premiumgarciniaextract,579,579,0
31:03:2014,premiumgreencoffee,http://goodpreview.info/premiumgreencoffee,118,119,-1
31:03:2014,premiumgreencoffee800,http://goodpreview.info/premiumgreencoffee800,107,107,0
31:03:2014,premiumraspberryketone,http://goodpreview.info/premiumraspberryketone,43,43,0
31:03:2014,primalitegarciniaextract,http://goodpreview.info/primalitegarciniaextract,677,677,0
31:03:2014,progain350,http://goodpreview.info/progain350,174,175,-1
31:03:2014,prograce,http://goodpreview.info/prograce,1,1,0
31:03:2014,promusclecomplex,http://goodpreview.info/promusclecomplex,48,48,0
31:03:2014,propowercleanse,http://goodpreview.info/propowercleanse,789,789,0
31:03:2014,pureberrymax,http://goodpreview.info/pureberrymax,212,212,0
31:03:2014,purecleansehealth,http://goodpreview.info/purecleansehealth,107,107,0
31:03:2014,purecollagen,http://goodpreview.info/purecollagen,2204,2204,0
31:03:2014,puregarciniacambogia,http://goodpreview.info/puregarciniacambogia,1196,1196,0
31:03:2014,puregarciniaslim,http://goodpreview.info/puregarciniaslim,127,127,0
31:03:2014,puregreencoffeebeanextract,http://goodpreview.info/puregreencoffeebeanextract,2691,2691,0
31:03:2014,puregreencoffeemaxima,http://goodpreview.info/puregreencoffeemaxima,36,37,-1
31:03:2014,puregriffonia,http://goodpreview.info/puregriffonia,96,96,0
31:03:2014,pureketoneslim,http://goodpreview.info/pureketoneslim,29,29,0
31:03:2014,purelifeclanse,http://goodpreview.info/purelifeclanse,101,101,0
31:03:2014,puremusclepro,http://goodpreview.info/puremusclepro,1794,1794,0
31:03:2014,purenaturalcleanser,http://goodpreview.info/purenaturalcleanser,476,476,0
31:03:2014,purephytoceramides,http://goodpreview.info/purephytoceramides,68,68,0
31:03:2014,pureraspberryketonepremium,http://goodpreview.info/pureraspberryketonepremium,62,62,0
31:03:2014,puresaffronslim,http://goodpreview.info/puresaffronslim,422,422,0
31:03:2014,pureslim57,http://goodpreview.info/pureslim57,124,125,-1
31:03:2014,purgarciniacambogia,http://goodpreview.info/purgarciniacambogia,156,156,0
31:03:2014,purgreencoffee,http://goodpreview.info/purgreencoffee,1622,1622,0
31:03:2014,purifyre,http://goodpreview.info/purifyre,241,241,0
31:03:2014,purifyregreencoffee,http://goodpreview.info/purifyregreencoffee,0,0,0
31:03:2014,raspberryhealth,http://goodpreview.info/raspberryhealth,39,39,0
31:03:2014,raspberryketoneblast,http://goodpreview.info/raspberryketoneblast,3985,3985,0
31:03:2014,raspberryketoned,http://goodpreview.info/raspberryketoned,2,2,0
31:03:2014,raspberryketoneoptimum,http://goodpreview.info/raspberryketoneoptimum,5,5,0
31:03:2014,raspberryketonepremium,http://goodpreview.info/raspberryketonepremium,76,76,0
31:03:2014,raspberryketonepure,http://goodpreview.info/raspberryketonepure,2,2,0
31:03:2014,raspberryketonethin,http://goodpreview.info/raspberryketonethin,401,401,0
31:03:2014,raspberryslimplus,http://goodpreview.info/raspberryslimplus,125,125,0
31:03:2014,refuelextreme,http://goodpreview.info/refuelextreme,452,452,0
31:03:2014,regalecig,http://goodpreview.info/regalecig,352,352,0
31:03:2014,regalecigs,http://goodpreview.info/regalecigs,39,39,0
31:03:2014,rejuvaglow,http://goodpreview.info/rejuvaglow,69,69,0
31:03:2014,rejuveneyemax,http://goodpreview.info/rejuveneyemax,1,1,0
31:03:2014,rellift,http://goodpreview.info/rellift,29,29,0
31:03:2014,renovo,http://goodpreview.info/renovo,23,23,0
31:03:2014,restiflex,http://goodpreview.info/restiflex,62,62,0
31:03:2014,revitalize,http://goodpreview.info/revitalize,24,24,0
31:03:2014,revitatone,http://goodpreview.info/revitatone,8652,8655,-3
31:03:2014,revolutionaryraspberryketone,http://goodpreview.info/revolutionaryraspberryketone,65,65,0
31:03:2014,revoreplex,http://goodpreview.info/revoreplex,114,114,0
31:03:2014,revtesttestosterone,http://goodpreview.info/revtesttestosterone,1587,1587,0
31:03:2014,rippedmusclex,http://goodpreview.info/rippedmusclex,154,155,-1
31:03:2014,rippedxburn,http://goodpreview.info/rippedxburn,181,181,0
31:03:2014,sacredarganoil,http://goodpreview.info/sacredarganoil,44,44,0
31:03:2014,safercolon,http://goodpreview.info/safercolon,2928,2928,0
31:03:2014,saffronextractpremium,http://goodpreview.info/saffronextractpremium,104,104,0
31:03:2014,saffronextractselect,http://goodpreview.info/saffronextractselect,1337,1337,0
31:03:2014,saffronselect,http://goodpreview.info/saffronselect,71,71,0
31:03:2014,secretgreencoffee,http://goodpreview.info/secretgreencoffee,241,242,-1
31:03:2014,simpleantiaging,http://goodpreview.info/simpleantiaging,226,226,0
31:03:2014,simplygarcinia,http://goodpreview.info/simplygarcinia,992,992,0
31:03:2014,skinlift,http://goodpreview.info/skinlift,2141,2141,0
31:03:2014,slendera,http://goodpreview.info/slendera,15,15,0
31:03:2014,slenderagc-1,http://goodpreview.info/slenderagc-1,382,382,0
31:03:2014,slimatrex,http://goodpreview.info/slimatrex,609,609,0
31:03:2014,slimhelper,http://goodpreview.info/slimhelper,244,244,0
31:03:2014,slimher,http://goodpreview.info/slimher,171,171,0
31:03:2014,slimmeryougarcinia,http://goodpreview.info/slimmeryougarcinia,0,0,0
31:03:2014,slimtropical,http://goodpreview.info/slimtropical,794,794,0
31:03:2014,slimtropicalmx,http://goodpreview.info/slimtropicalmx,133,133,0
31:03:2014,slimzenu,http://goodpreview.info/slimzenu,197,197,0
31:03:2014,smokestarecig,http://goodpreview.info/smokestarecig,510,510,0
31:03:2014,solpriaxtreme,http://goodpreview.info/solpriaxtreme,2758,2758,0
31:03:2014,sorepressin,http://goodpreview.info/sorepressin,4,4,0
31:03:2014,speedtrimxs,http://goodpreview.info/speedtrimxs,89,89,0
31:03:2014,splendyr,http://goodpreview.info/splendyr,1271,1271,0
31:03:2014,splendyrantiaging,http://goodpreview.info/splendyrantiaging,51,51,0
31:03:2014,superacaicleanse,http://goodpreview.info/superacaicleanse,19,20,-1
31:03:2014,supercleansetotal,http://goodpreview.info/supercleansetotal,52,52,0
31:03:2014,supergreencoffee,http://goodpreview.info/supergreencoffee,10,10,0
31:03:2014,supergreencoffeebean,http://goodpreview.info/supergreencoffeebean,20,20,0
31:03:2014,superiormusclex,http://goodpreview.info/superiormusclex,74,74,0
31:03:2014,superiorvelvet,http://goodpreview.info/superiorvelvet,1,1,0
31:03:2014,superyacon1000,http://goodpreview.info/superyacon1000,17,17,0
31:03:2014,supracleanse350,http://goodpreview.info/supracleanse350,0,0,0
31:03:2014,supragreencoffee,http://goodpreview.info/supragreencoffee,873,873,0
31:03:2014,supragreencoffeebean,http://goodpreview.info/supragreencoffeebean,0,0,0
31:03:2014,surelyyoung,http://goodpreview.info/surelyyoung,26,26,0
31:03:2014,swissrose,http://goodpreview.info/swissrose,336,337,-1
31:03:2014,swolekreate,http://goodpreview.info/swolekreate,189,189,0
31:03:2014,syneocell,http://goodpreview.info/syneocell,48,48,0
31:03:2014,t-force,http://goodpreview.info/t-force,168,168,0
31:03:2014,testforcextreme,http://goodpreview.info/testforcextreme,486,486,0
31:03:2014,testoforce,http://goodpreview.info/testoforce,12,12,0
31:03:2014,testorushrx,http://goodpreview.info/testorushrx,37,37,0
31:03:2014,testosteronemax,http://goodpreview.info/testosteronemax,321,321,0
31:03:2014,testoxl,http://goodpreview.info/testoxl,1455,1455,0
31:03:2014,thinmagic,http://goodpreview.info/thinmagic,235,235,0
31:03:2014,thinmagicmax,http://goodpreview.info/thinmagicmax,0,0,0
31:03:2014,thinsport,http://goodpreview.info/thinsport,211,211,0
31:03:2014,titaniumprox,http://goodpreview.info/titaniumprox,0,0,0
31:03:2014,totalbodyfresh,http://goodpreview.info/totalbodyfresh,109,109,0
31:03:2014,trigx2,http://goodpreview.info/trigx2,4,4,0
31:03:2014,trimaleana,http://goodpreview.info/trimaleana,135,135,0
31:03:2014,trimatol,http://goodpreview.info/trimatol,118,118,0
31:03:2014,trimblendgarciniacambogia,http://goodpreview.info/trimblendgarciniacambogia,71,71,0
31:03:2014,triminexgarciniacambogia,http://goodpreview.info/triminexgarciniacambogia,77,77,0
31:03:2014,triminexgreencoffee,http://goodpreview.info/triminexgreencoffee,49,49,0
31:03:2014,tripleeffectseyeserum,http://goodpreview.info/tripleeffectseyeserum,589,589,0
31:03:2014,turboextracut,http://goodpreview.info/turboextracut,155,155,0
31:03:2014,turboshred,http://goodpreview.info/turboshred,100,100,0
31:03:2014,ultimategarcinia,http://goodpreview.info/ultimategarcinia,162,162,0
31:03:2014,ultramaxtestosterone,http://goodpreview.info/ultramaxtestosterone,33,33,0
31:03:2014,ultrapurecoloncleanse,http://goodpreview.info/ultrapurecoloncleanse,348,348,0
31:03:2014,ultraraspberryketone,http://goodpreview.info/ultraraspberryketone,418,418,0
31:03:2014,velora,http://goodpreview.info/velora,22,22,0
31:03:2014,velveskin,http://goodpreview.info/velveskin,7,7,0
31:03:2014,vencleanse,http://goodpreview.info/vencleanse,425,425,0
31:03:2014,viarex,http://goodpreview.info/viarex,587,587,0
31:03:2014,vitalifedetox,http://goodpreview.info/vitalifedetox,253,253,0
31:03:2014,vitalitygreencoffee,http://goodpreview.info/vitalitygreencoffee,84,84,0
31:03:2014,vitamax,http://goodpreview.info/vitamax,22,22,0
31:03:2014,vitolipo,http://goodpreview.info/vitolipo,1113,1113,0
31:03:2014,vydox,http://goodpreview.info/vydox,290,290,0
31:03:2014,wildraspberryketone,http://goodpreview.info/wildraspberryketone,141,141,0
31:03:2014,wrinklesscream,http://goodpreview.info/wrinklesscream,252,252,0
31:03:2014,xenaslim,http://goodpreview.info/xenaslim,40,40,0
31:03:2014,xengthx1,http://goodpreview.info/xengthx1,29,29,0
31:03:2014,xlerator,http://goodpreview.info/xlerator,0,0,0
31:03:2014,xocigs,http://goodpreview.info/xocigs,60,60,0
31:03:2014,xtgenix,http://goodpreview.info/xtgenix,12913,12913,0
31:03:2014,xtrememusclepro,http://goodpreview.info/xtrememusclepro,604,604,0
31:03:2014,yaconsplash,http://goodpreview.info/yaconsplash,18,18,0
31:03:2014,yaconsyruporiginal,http://goodpreview.info/yaconsyruporiginal,92,93,-1
31:03:2014,yaconsyrupsecret,http://goodpreview.info/yaconsyrupsecret,29,30,-1
31:03:2014,yoloboost,http://goodpreview.info/yoloboost,135,135,0
31:03:2014,youthkiteyecream,http://goodpreview.info/youthkiteyecream,239,239,0
