dt_today,sitetitle,sitelink,pre_click,new_clicks,difrnce
11:04:2014,11fruits,http://goodpreview.info/11fruits,207,208,-1
11:04:2014,1285muscle,http://goodpreview.info/1285muscle,2875,2876,-1
11:04:2014,92trimgreencoffee,http://goodpreview.info/92trimgreencoffee,37,38,-1
11:04:2014,Americig,http://goodpreview.info/Americig,469,475,-6
11:04:2014,Nuvagenic,http://goodpreview.info/Nuvagenic,1110,1113,-3
11:04:2014,Prolexin,http://goodpreview.info/Prolexin,987,1044,-57
11:04:2014,SVELME,http://goodpreview.info/SVELME,801,802,-1
11:04:2014,SlimSpray,http://goodpreview.info/SlimSpray,296,299,-3
11:04:2014,acaiberryfresh,http://goodpreview.info/acaiberryfresh,98,98,0
11:04:2014,acainatural,http://goodpreview.info/acainatural,133,133,0
11:04:2014,acaiultralean,http://goodpreview.info/acaiultralean,133,133,0
11:04:2014,advancedgarciniacambogia,http://goodpreview.info/advancedgarciniacambogia,885,885,0
11:04:2014,advancedgarciniacambogia-fr,http://goodpreview.info/advancedgarciniacambogia-fr,149,154,-5
11:04:2014,advancedgarciniacambogia1,http://goodpreview.info/advancedgarciniacambogia1,39,39,0
11:04:2014,advancedkrealkalyn,http://goodpreview.info/advancedkrealkalyn,147,148,-1
11:04:2014,advancedpurecleanse,http://goodpreview.info/advancedpurecleanse,0,0,0
11:04:2014,advancedpurecleanse1,http://goodpreview.info/advancedpurecleanse1,45,48,-3
11:04:2014,africanmangoboost,http://goodpreview.info/africanmangoboost,118,118,0
11:04:2014,africanmangoprox,http://goodpreview.info/africanmangoprox,45,45,0
11:04:2014,africanmangopure,http://goodpreview.info/africanmangopure,77,77,0
11:04:2014,aktiveam,http://goodpreview.info/aktiveam,1610,1612,-2
11:04:2014,aktivepm,http://goodpreview.info/aktivepm,2040,2053,-13
11:04:2014,alphajacked,http://goodpreview.info/alphajacked,773,773,0
11:04:2014,alphamaxplus,http://goodpreview.info/alphamaxplus,18,18,0
11:04:2014,amazing,http://goodpreview.info/amazing,385,388,-3
11:04:2014,aminomuscle,http://goodpreview.info/aminomuscle,1220,1225,-5
11:04:2014,aminoprime,http://goodpreview.info/aminoprime,113,114,-1
11:04:2014,aminoprimexl,http://goodpreview.info/aminoprimexl,298,299,-1
11:04:2014,anabolicrx24,http://goodpreview.info/anabolicrx24,19206,19411,-205
11:04:2014,anatomyx5,http://goodpreview.info/anatomyx5,3,3,0
11:04:2014,androsolve,http://goodpreview.info/androsolve,1483,1483,0
11:04:2014,androx,http://goodpreview.info/androx,14128,14320,-192
11:04:2014,anoradrol,http://goodpreview.info/anoradrol,222,222,0
11:04:2014,auravie,http://goodpreview.info/auravie,106,106,0
11:04:2014,authenticgreencoffee,http://goodpreview.info/authenticgreencoffee,240,240,0
11:04:2014,beaudify,http://goodpreview.info/beaudify,75,75,0
11:04:2014,beautefxbbcream,http://goodpreview.info/beautefxbbcream,4,4,0
11:04:2014,beautynectarcollagen,http://goodpreview.info/beautynectarcollagen,135,135,0
11:04:2014,beddefense,http://goodpreview.info/beddefense,28,30,-2
11:04:2014,bellagenix,http://goodpreview.info/bellagenix,138,138,0
11:04:2014,bellalabs,http://goodpreview.info/bellalabs,8,8,0
11:04:2014,bellaplex,http://goodpreview.info/bellaplex,8,8,0
11:04:2014,beriultimatepro,http://goodpreview.info/beriultimatepro,69,69,0
11:04:2014,berrythin,http://goodpreview.info/berrythin,332,333,-1
11:04:2014,betaalaninemax,http://goodpreview.info/betaalaninemax,0,0,0
11:04:2014,betaalaninextreme,http://goodpreview.info/betaalaninextreme,19,19,0
11:04:2014,beyondraspberry,http://goodpreview.info/beyondraspberry,77,77,0
11:04:2014,biohealthgarciniacambogia,http://goodpreview.info/biohealthgarciniacambogia,3743,3782,-39
11:04:2014,biomelt,http://goodpreview.info/biomelt,364,368,-4
11:04:2014,blastxl,http://goodpreview.info/blastxl,172,174,-2
11:04:2014,bodycleanseplus,http://goodpreview.info/bodycleanseplus,67,67,0
11:04:2014,bodywrap,http://goodpreview.info/bodywrap,209,210,-1
11:04:2014,breakfree,http://goodpreview.info/breakfree,113,114,-1
11:04:2014,cambogiatrim,http://goodpreview.info/cambogiatrim,600,601,-1
11:04:2014,capsicum,http://goodpreview.info/capsicum,140,141,-1
11:04:2014,celebritycleanser,http://goodpreview.info/celebritycleanser,291,359,-68
11:04:2014,celebrityraspberry,http://goodpreview.info/celebrityraspberry,147,149,-2
11:04:2014,cellanafricanmango,http://goodpreview.info/cellanafricanmango,270,270,0
11:04:2014,cellogicaskin,http://goodpreview.info/cellogicaskin,52,52,0
11:04:2014,centrislim,http://goodpreview.info/centrislim,199,199,0
11:04:2014,certifiedgreencoffee,http://goodpreview.info/certifiedgreencoffee,149,150,-1
11:04:2014,certifiedpuregreencoffee,http://goodpreview.info/certifiedpuregreencoffee,19,20,-1
11:04:2014,chiocegreencoffee,http://goodpreview.info/chiocegreencoffee,545,545,0
11:04:2014,choicegreencoffee,http://goodpreview.info/choicegreencoffee,399,404,-5
11:04:2014,cleansefx,http://goodpreview.info/cleansefx,513,549,-36
11:04:2014,cleanseplus,http://goodpreview.info/cleanseplus,438,438,0
11:04:2014,cleanseplus1,http://goodpreview.info/cleanseplus1,0,0,0
11:04:2014,cleansepremium,http://goodpreview.info/cleansepremium,15,16,-1
11:04:2014,cleansewonder,http://goodpreview.info/cleansewonder,2,6,-4
11:04:2014,cleansextrem,http://goodpreview.info/cleansextrem,369,422,-53
11:04:2014,cleantrim,http://goodpreview.info/cleantrim,231,231,0
11:04:2014,clearcleansepro,http://goodpreview.info/clearcleansepro,114,114,0
11:04:2014,clearsmoke,http://goodpreview.info/clearsmoke,177,178,-1
11:04:2014,codered7,http://goodpreview.info/codered7,322,331,-9
11:04:2014,coleanse,http://goodpreview.info/coleanse,126,126,0
11:04:2014,collaton,http://goodpreview.info/collaton,88,90,-2
11:04:2014,colocleansepro,http://goodpreview.info/colocleansepro,1,1,0
11:04:2014,coloncleansetotal,http://goodpreview.info/coloncleansetotal,22,23,-1
11:04:2014,colonpurecleanse,http://goodpreview.info/colonpurecleanse,133,133,0
11:04:2014,colothin,http://goodpreview.info/colothin,997,999,-2
11:04:2014,completecoffeecleanse,http://goodpreview.info/completecoffeecleanse,1991,1991,0
11:04:2014,complexiderm,http://goodpreview.info/complexiderm,109,111,-2
11:04:2014,corecutter,http://goodpreview.info/corecutter,42,44,-2
11:04:2014,csorex,http://goodpreview.info/csorex,180,180,0
11:04:2014,dailyfacelift,http://goodpreview.info/dailyfacelift,99,100,-1
11:04:2014,dailyfacestemcelltechnology,http://goodpreview.info/dailyfacestemcelltechnology,197,197,0
11:04:2014,dailypowercleanse,http://goodpreview.info/dailypowercleanse,130,133,-3
11:04:2014,deerantlerxtreme,http://goodpreview.info/deerantlerxtreme,136,137,-1
11:04:2014,dermarose,http://goodpreview.info/dermarose,113,115,-2
11:04:2014,dermaset,http://goodpreview.info/dermaset,51,51,0
11:04:2014,dermpure,http://goodpreview.info/dermpure,80,80,0
11:04:2014,dietgreencoffeebean,http://goodpreview.info/dietgreencoffeebean,313,314,-1
11:04:2014,drillpill,http://goodpreview.info/drillpill,458,459,-1
11:04:2014,elevategf,http://goodpreview.info/elevategf,178,178,0
11:04:2014,elier,http://goodpreview.info/elier,51,51,0
11:04:2014,elierskincare,http://goodpreview.info/elierskincare,41,41,0
11:04:2014,elitetest360,http://goodpreview.info/elitetest360,484,492,-8
11:04:2014,emeraldluxecig,http://goodpreview.info/emeraldluxecig,113,114,-1
11:04:2014,enduros,http://goodpreview.info/enduros,988,995,-7
11:04:2014,envigra,http://goodpreview.info/envigra,106,107,-1
11:04:2014,estrodetox,http://goodpreview.info/estrodetox,102,102,0
11:04:2014,extentxl,http://goodpreview.info/extentxl,176,178,-2
11:04:2014,fembalance,http://goodpreview.info/fembalance,17,17,0
11:04:2014,flawlessraspberryketone,http://goodpreview.info/flawlessraspberryketone,90,90,0
11:04:2014,formulat10,http://goodpreview.info/formulat10,1516,1523,-7
11:04:2014,garcinaiawow1,http://goodpreview.info/garcinaiawow1,118,125,-7
11:04:2014,garciniacambogia,http://goodpreview.info/garciniacambogia,404,427,-23
11:04:2014,garciniacambogia1000,http://goodpreview.info/garciniacambogia1000,62,62,0
11:04:2014,garciniacambogiaelite,http://goodpreview.info/garciniacambogiaelite,5349,5360,-11
11:04:2014,garciniacambogiafatbuster,http://goodpreview.info/garciniacambogiafatbuster,91,92,-1
11:04:2014,garciniacambogiamax,http://goodpreview.info/garciniacambogiamax,2428,2436,-8
11:04:2014,garciniacambogiamiracle,http://goodpreview.info/garciniacambogiamiracle,131,132,-1
11:04:2014,garciniacambogiapremium,http://goodpreview.info/garciniacambogiapremium,1076,1076,0
11:04:2014,garciniacambogiapureextract,http://goodpreview.info/garciniacambogiapureextract,146,146,0
11:04:2014,garciniacambogiapureselect,http://goodpreview.info/garciniacambogiapureselect,1,4,-3
11:04:2014,garciniacambogiasupreme,http://goodpreview.info/garciniacambogiasupreme,3606,3680,-74
11:04:2014,garciniacambogiatoday,http://goodpreview.info/garciniacambogiatoday,144,144,0
11:04:2014,garciniacambogiaultra,http://goodpreview.info/garciniacambogiaultra,371,379,-8
11:04:2014,garciniaforte,http://goodpreview.info/garciniaforte,84,91,-7
11:04:2014,garciniafreetrial,http://goodpreview.info/garciniafreetrial,69,69,0
11:04:2014,garciniagreen,http://goodpreview.info/garciniagreen,847,847,0
11:04:2014,garciniapureelite1,http://goodpreview.info/garciniapureelite1,1,1,0
11:04:2014,garciniatoday,http://goodpreview.info/garciniatoday,0,0,0
11:04:2014,garciniatotal,http://goodpreview.info/garciniatotal,110,114,-4
11:04:2014,garciniawow,http://goodpreview.info/garciniawow,1079,1100,-21
11:04:2014,garcinium,http://goodpreview.info/garcinium,50,67,-17
11:04:2014,gc7x,http://goodpreview.info/gc7x,103,103,0
11:04:2014,gc7xgreencoffee,http://goodpreview.info/gc7xgreencoffee,0,0,0
11:04:2014,gcbultra,http://goodpreview.info/gcbultra,53,53,0
11:04:2014,gcbx,http://goodpreview.info/gcbx,17108,17109,-1
11:04:2014,gcbx1,http://goodpreview.info/gcbx1,196,196,0
11:04:2014,gcspeedslim,http://goodpreview.info/gcspeedslim,5848,5866,-18
11:04:2014,gcultra,http://goodpreview.info/gcultra,137,137,0
11:04:2014,gcultragarcinia,http://goodpreview.info/gcultragarcinia,4,4,0
11:04:2014,geneme,http://goodpreview.info/geneme,40,40,0
11:04:2014,getnaturalgarcinia,http://goodpreview.info/getnaturalgarcinia,43,44,-1
11:04:2014,greencoffeeadvanced,http://goodpreview.info/greencoffeeadvanced,182,182,0
11:04:2014,greencoffeebean8000,http://goodpreview.info/greencoffeebean8000,66,67,-1
11:04:2014,greencoffeebody,http://goodpreview.info/greencoffeebody,33,33,0
11:04:2014,greencoffeeburn,http://goodpreview.info/greencoffeeburn,25,26,-1
11:04:2014,greencoffeeextreme,http://goodpreview.info/greencoffeeextreme,85,85,0
11:04:2014,greencoffeemax,http://goodpreview.info/greencoffeemax,139,139,0
11:04:2014,greencoffeemaxx,http://goodpreview.info/greencoffeemaxx,7,7,0
11:04:2014,greencoffeeoptimum,http://goodpreview.info/greencoffeeoptimum,125,125,0
11:04:2014,greencoffeeprogram,http://goodpreview.info/greencoffeeprogram,0,0,0
11:04:2014,greencoffeeultraslim,http://goodpreview.info/greencoffeeultraslim,208,210,-2
11:04:2014,greentonepro,http://goodpreview.info/greentonepro,310,310,0
11:04:2014,healthetrimgarcinia,http://goodpreview.info/healthetrimgarcinia,154,156,-2
11:04:2014,healthychoicegc,http://goodpreview.info/healthychoicegc,752,753,-1
11:04:2014,horsepowerplusxxxl,http://goodpreview.info/horsepowerplusxxxl,299,307,-8
11:04:2014,hugegenic,http://goodpreview.info/hugegenic,367,376,-9
11:04:2014,hydrellatone,http://goodpreview.info/hydrellatone,105,105,0
11:04:2014,hydrocollagen,http://goodpreview.info/hydrocollagen,46,47,-1
11:04:2014,hydroderm,http://goodpreview.info/hydroderm,47,47,0
11:04:2014,hyperfuel9x,http://goodpreview.info/hyperfuel9x,1968,1985,-17
11:04:2014,illuminatedteeth,http://goodpreview.info/illuminatedteeth,55,56,-1
11:04:2014,instantwrinklerepair,http://goodpreview.info/instantwrinklerepair,18,18,0
11:04:2014,iqderma,http://goodpreview.info/iqderma,421,423,-2
11:04:2014,iqdermaessen,http://goodpreview.info/iqdermaessen,0,0,0
11:04:2014,ketoneoptimum,http://goodpreview.info/ketoneoptimum,156,156,0
11:04:2014,kleanslim,http://goodpreview.info/kleanslim,100,100,0
11:04:2014,lacreme,http://goodpreview.info/lacreme,59,81,-22
11:04:2014,leanmuscleformula,http://goodpreview.info/leanmuscleformula,61,63,-2
11:04:2014,ledermeluxe,http://goodpreview.info/ledermeluxe,186,187,-1
11:04:2014,leparfait,http://goodpreview.info/leparfait,29,31,-2
11:04:2014,leparisehydragold,http://goodpreview.info/leparisehydragold,4,6,-2
11:04:2014,levela,http://goodpreview.info/levela,106,107,-1
11:04:2014,lifedetox,http://goodpreview.info/lifedetox,146,146,0
11:04:2014,liftserumpro,http://goodpreview.info/liftserumpro,193,193,0
11:04:2014,liposlender,http://goodpreview.info/liposlender,29,29,0
11:04:2014,liposlim,http://goodpreview.info/liposlim,1911,1921,-10
11:04:2014,liposom,http://goodpreview.info/liposom,63,63,0
11:04:2014,liveskinny,http://goodpreview.info/liveskinny,234,236,-2
11:04:2014,lumahydrate,http://goodpreview.info/lumahydrate,427,433,-6
11:04:2014,lumarepair,http://goodpreview.info/lumarepair,510,516,-6
11:04:2014,lunathin,http://goodpreview.info/lunathin,127,129,-2
11:04:2014,luxoderm,http://goodpreview.info/luxoderm,218,223,-5
11:04:2014,lysocleanse,http://goodpreview.info/lysocleanse,1840,1853,-13
11:04:2014,maxdetoxpro,http://goodpreview.info/maxdetoxpro,576,578,-2
11:04:2014,maxgarciniaburn,http://goodpreview.info/maxgarciniaburn,456,456,0
11:04:2014,maximumshred,http://goodpreview.info/maximumshred,1545,1551,-6
11:04:2014,maxrobust,http://goodpreview.info/maxrobust,266,266,0
11:04:2014,maxrobustxtreme,http://goodpreview.info/maxrobustxtreme,523,523,0
11:04:2014,mightyraspberryketone,http://goodpreview.info/mightyraspberryketone,5123,5124,-1
11:04:2014,miraclegarciniacambogia,http://goodpreview.info/miraclegarciniacambogia,506,511,-5
11:04:2014,miraclegreencoffee,http://goodpreview.info/miraclegreencoffee,554,555,-1
11:04:2014,miraclesaffron,http://goodpreview.info/miraclesaffron,52,53,-1
11:04:2014,mitoslim,http://goodpreview.info/mitoslim,2062,2062,0
11:04:2014,musclefactorx,http://goodpreview.info/musclefactorx,1447,1449,-2
11:04:2014,musclefactorx-1,http://goodpreview.info/musclefactorx-1,22,22,0
11:04:2014,musclekingpro,http://goodpreview.info/musclekingpro,503,504,-1
11:04:2014,musclemaxextreme,http://goodpreview.info/musclemaxextreme,137,137,0
11:04:2014,muscleplus,http://goodpreview.info/muscleplus,143,143,0
11:04:2014,musclerevolutionpro,http://goodpreview.info/musclerevolutionpro,1439,1444,-5
11:04:2014,musclerevx,http://goodpreview.info/musclerevx,104,107,-3
11:04:2014,musclerevxtreme,http://goodpreview.info/musclerevxtreme,65,66,-1
11:04:2014,musclexlerator,http://goodpreview.info/musclexlerator,32,32,0
11:04:2014,musclexmax,http://goodpreview.info/musclexmax,1464,1467,-3
11:04:2014,musclexmax1,http://goodpreview.info/musclexmax1,280,280,0
11:04:2014,musclezx90,http://goodpreview.info/musclezx90,5018,5018,0
11:04:2014,naturalcleanse,http://goodpreview.info/naturalcleanse,8055,8064,-9
11:04:2014,naturalgarciniacambogia,http://goodpreview.info/naturalgarciniacambogia,2774,2779,-5
11:04:2014,naturalgreencoffee,http://goodpreview.info/naturalgreencoffee,9,9,0
11:04:2014,naturalhealthgarcinia,http://goodpreview.info/naturalhealthgarcinia,54,54,0
11:04:2014,naturalpurecleanse,http://goodpreview.info/naturalpurecleanse,28,34,-6
11:04:2014,nauseam,http://goodpreview.info/nauseam,135,135,0
11:04:2014,nauseamplus,http://goodpreview.info/nauseamplus,0,0,0
11:04:2014,nextrim,http://goodpreview.info/nextrim,1744,1747,-3
11:04:2014,nitricmusclemax,http://goodpreview.info/nitricmusclemax,14654,14838,-184
11:04:2014,nitrofocusno3,http://goodpreview.info/nitrofocusno3,110,114,-4
11:04:2014,niwali,http://goodpreview.info/niwali,830,841,-11
11:04:2014,no2explodeextreme,http://goodpreview.info/no2explodeextreme,163,164,-1
11:04:2014,no2extremerush,http://goodpreview.info/no2extremerush,1313,1314,-1
11:04:2014,noflameecigs,http://goodpreview.info/noflameecigs,350,350,0
11:04:2014,nuclearno,http://goodpreview.info/nuclearno,368,369,-1
11:04:2014,nuetrim,http://goodpreview.info/nuetrim,660,660,0
11:04:2014,nutragreencoffee,http://goodpreview.info/nutragreencoffee,15,22,-7
11:04:2014,nutrapuregarcinia,http://goodpreview.info/nutrapuregarcinia,215,216,-1
11:04:2014,nutratoneplus,http://goodpreview.info/nutratoneplus,1005,1007,-2
11:04:2014,nutriberryslim,http://goodpreview.info/nutriberryslim,1287,1318,-31
11:04:2014,nuvoryn,http://goodpreview.info/nuvoryn,22,22,0
11:04:2014,optimalstack,http://goodpreview.info/optimalstack,1714,1750,-36
11:04:2014,optimummuscle,http://goodpreview.info/optimummuscle,209,209,0
11:04:2014,organicgreencoffee,http://goodpreview.info/organicgreencoffee,91,91,0
11:04:2014,organicwhitekidneybean,http://goodpreview.info/organicwhitekidneybean,91,91,0
11:04:2014,orviax,http://goodpreview.info/orviax,89,89,0
11:04:2014,oxitamin,http://goodpreview.info/oxitamin,149,149,0
11:04:2014,phtytoceramides,http://goodpreview.info/phtytoceramides,832,832,0
11:04:2014,powerigf,http://goodpreview.info/powerigf,1911,1946,-35
11:04:2014,powerpumpxl,http://goodpreview.info/powerpumpxl,370,371,-1
11:04:2014,powerup,http://goodpreview.info/powerup,121,121,0
11:04:2014,premiermangocleanse,http://goodpreview.info/premiermangocleanse,519,520,-1
11:04:2014,premiumcleanse,http://goodpreview.info/premiumcleanse,2809,2816,-7
11:04:2014,premiumgarciniacambogia,http://goodpreview.info/premiumgarciniacambogia,404,404,0
11:04:2014,premiumgarciniaextract,http://goodpreview.info/premiumgarciniaextract,715,715,0
11:04:2014,premiumgreencoffee,http://goodpreview.info/premiumgreencoffee,121,122,-1
11:04:2014,premiumgreencoffee800,http://goodpreview.info/premiumgreencoffee800,108,108,0
11:04:2014,premiumraspberryketone,http://goodpreview.info/premiumraspberryketone,44,44,0
11:04:2014,primalitegarciniaextract,http://goodpreview.info/primalitegarciniaextract,775,782,-7
11:04:2014,progain350,http://goodpreview.info/progain350,270,281,-11
11:04:2014,prograce,http://goodpreview.info/prograce,5,6,-1
11:04:2014,promusclecomplex,http://goodpreview.info/promusclecomplex,49,49,0
11:04:2014,propowercleanse,http://goodpreview.info/propowercleanse,1253,1272,-19
11:04:2014,pureberrymax,http://goodpreview.info/pureberrymax,215,216,-1
11:04:2014,purecleansehealth,http://goodpreview.info/purecleansehealth,111,111,0
11:04:2014,purecollagen,http://goodpreview.info/purecollagen,2229,2230,-1
11:04:2014,puregarciniacambogia,http://goodpreview.info/puregarciniacambogia,1218,1220,-2
11:04:2014,puregarciniaslim,http://goodpreview.info/puregarciniaslim,174,175,-1
11:04:2014,puregreencoffeebeanextract,http://goodpreview.info/puregreencoffeebeanextract,2735,2740,-5
11:04:2014,puregreencoffeemaxima,http://goodpreview.info/puregreencoffeemaxima,37,37,0
11:04:2014,puregriffonia,http://goodpreview.info/puregriffonia,96,97,-1
11:04:2014,pureketoneslim,http://goodpreview.info/pureketoneslim,34,34,0
11:04:2014,purelifeclanse,http://goodpreview.info/purelifeclanse,15,18,-3
11:04:2014,puremusclepro,http://goodpreview.info/puremusclepro,1811,1811,0
11:04:2014,purenaturalcleanser,http://goodpreview.info/purenaturalcleanser,482,484,-2
11:04:2014,purephytoceramides,http://goodpreview.info/purephytoceramides,79,79,0
11:04:2014,pureraspberryketonepremium,http://goodpreview.info/pureraspberryketonepremium,64,64,0
11:04:2014,puresaffronslim,http://goodpreview.info/puresaffronslim,424,424,0
11:04:2014,pureslim57,http://goodpreview.info/pureslim57,130,131,-1
11:04:2014,purgarciniacambogia,http://goodpreview.info/purgarciniacambogia,158,158,0
11:04:2014,purgreencoffee,http://goodpreview.info/purgreencoffee,1627,1629,-2
11:04:2014,purifyre,http://goodpreview.info/purifyre,244,244,0
11:04:2014,purifyregreencoffee,http://goodpreview.info/purifyregreencoffee,0,0,0
11:04:2014,raspberryhealth,http://goodpreview.info/raspberryhealth,71,72,-1
11:04:2014,raspberryketoneblast,http://goodpreview.info/raspberryketoneblast,4533,4577,-44
11:04:2014,raspberryketoned,http://goodpreview.info/raspberryketoned,7,8,-1
11:04:2014,raspberryketoneoptimum,http://goodpreview.info/raspberryketoneoptimum,5,5,0
11:04:2014,raspberryketonepremium,http://goodpreview.info/raspberryketonepremium,79,79,0
11:04:2014,raspberryketonepure,http://goodpreview.info/raspberryketonepure,2,2,0
11:04:2014,raspberryketonethin,http://goodpreview.info/raspberryketonethin,66,75,-9
11:04:2014,raspberryslimplus,http://goodpreview.info/raspberryslimplus,131,131,0
11:04:2014,refuelextreme,http://goodpreview.info/refuelextreme,524,529,-5
11:04:2014,regalecig,http://goodpreview.info/regalecig,382,384,-2
11:04:2014,regalecigs,http://goodpreview.info/regalecigs,44,44,0
11:04:2014,rejuvaglow,http://goodpreview.info/rejuvaglow,71,71,0
11:04:2014,rejuveneyemax,http://goodpreview.info/rejuveneyemax,119,127,-8
11:04:2014,rellift,http://goodpreview.info/rellift,30,30,0
11:04:2014,renovo,http://goodpreview.info/renovo,42,43,-1
11:04:2014,restiflex,http://goodpreview.info/restiflex,64,65,-1
11:04:2014,revitalize,http://goodpreview.info/revitalize,26,26,0
11:04:2014,revitatone,http://goodpreview.info/revitatone,9115,9145,-30
11:04:2014,revolutionaryraspberryketone,http://goodpreview.info/revolutionaryraspberryketone,65,65,0
11:04:2014,revoreplex,http://goodpreview.info/revoreplex,19,23,-4
11:04:2014,revtesttestosterone,http://goodpreview.info/revtesttestosterone,1596,1597,-1
11:04:2014,rippedmusclex,http://goodpreview.info/rippedmusclex,212,219,-7
11:04:2014,rippedxburn,http://goodpreview.info/rippedxburn,193,198,-5
11:04:2014,sacredarganoil,http://goodpreview.info/sacredarganoil,49,49,0
11:04:2014,safercolon,http://goodpreview.info/safercolon,3404,3446,-42
11:04:2014,saffronextractpremium,http://goodpreview.info/saffronextractpremium,108,108,0
11:04:2014,saffronextractselect,http://goodpreview.info/saffronextractselect,1385,1388,-3
11:04:2014,saffronselect,http://goodpreview.info/saffronselect,77,77,0
11:04:2014,secretgreencoffee,http://goodpreview.info/secretgreencoffee,280,283,-3
11:04:2014,simpleantiaging,http://goodpreview.info/simpleantiaging,231,231,0
11:04:2014,simplygarcinia,http://goodpreview.info/simplygarcinia,1220,1235,-15
11:04:2014,skinlift,http://goodpreview.info/skinlift,2158,2159,-1
11:04:2014,slendera,http://goodpreview.info/slendera,15,15,0
11:04:2014,slenderagc-1,http://goodpreview.info/slenderagc-1,425,431,-6
11:04:2014,slimatrex,http://goodpreview.info/slimatrex,622,624,-2
11:04:2014,slimhelper,http://goodpreview.info/slimhelper,247,247,0
11:04:2014,slimher,http://goodpreview.info/slimher,172,172,0
11:04:2014,slimmeryougarcinia,http://goodpreview.info/slimmeryougarcinia,0,0,0
11:04:2014,slimtropical,http://goodpreview.info/slimtropical,814,815,-1
11:04:2014,slimtropicalmx,http://goodpreview.info/slimtropicalmx,136,136,0
11:04:2014,slimzenu,http://goodpreview.info/slimzenu,201,201,0
11:04:2014,smokestarecig,http://goodpreview.info/smokestarecig,561,562,-1
11:04:2014,solpriaxtreme,http://goodpreview.info/solpriaxtreme,2802,2804,-2
11:04:2014,sorepressin,http://goodpreview.info/sorepressin,6,6,0
11:04:2014,speedtrimxs,http://goodpreview.info/speedtrimxs,95,95,0
11:04:2014,splendyr,http://goodpreview.info/splendyr,1276,1277,-1
11:04:2014,splendyrantiaging,http://goodpreview.info/splendyrantiaging,52,52,0
11:04:2014,superacaicleanse,http://goodpreview.info/superacaicleanse,23,23,0
11:04:2014,supercleansetotal,http://goodpreview.info/supercleansetotal,94,99,-5
11:04:2014,supergreencoffee,http://goodpreview.info/supergreencoffee,11,11,0
11:04:2014,supergreencoffeebean,http://goodpreview.info/supergreencoffeebean,20,20,0
11:04:2014,superiormusclex,http://goodpreview.info/superiormusclex,42,49,-7
11:04:2014,superiorvelvet,http://goodpreview.info/superiorvelvet,1,1,0
11:04:2014,superyacon1000,http://goodpreview.info/superyacon1000,27,27,0
11:04:2014,supracleanse350,http://goodpreview.info/supracleanse350,0,0,0
11:04:2014,supragreencoffee,http://goodpreview.info/supragreencoffee,951,962,-11
11:04:2014,supragreencoffeebean,http://goodpreview.info/supragreencoffeebean,0,0,0
11:04:2014,surelyyoung,http://goodpreview.info/surelyyoung,32,32,0
11:04:2014,swissrose,http://goodpreview.info/swissrose,345,349,-4
11:04:2014,swolekreate,http://goodpreview.info/swolekreate,194,194,0
11:04:2014,syneocell,http://goodpreview.info/syneocell,63,63,0
11:04:2014,t-force,http://goodpreview.info/t-force,212,214,-2
11:04:2014,testforcextreme,http://goodpreview.info/testforcextreme,493,493,0
11:04:2014,testoforce,http://goodpreview.info/testoforce,24,25,-1
11:04:2014,testorushrx,http://goodpreview.info/testorushrx,43,43,0
11:04:2014,testosteronemax,http://goodpreview.info/testosteronemax,333,333,0
11:04:2014,testoxl,http://goodpreview.info/testoxl,1489,1491,-2
11:04:2014,thinmagic,http://goodpreview.info/thinmagic,278,279,-1
11:04:2014,thinmagicmax,http://goodpreview.info/thinmagicmax,0,0,0
11:04:2014,thinsport,http://goodpreview.info/thinsport,212,212,0
11:04:2014,titaniumprox,http://goodpreview.info/titaniumprox,0,0,0
11:04:2014,totalbodyfresh,http://goodpreview.info/totalbodyfresh,132,136,-4
11:04:2014,trigx2,http://goodpreview.info/trigx2,15,18,-3
11:04:2014,trimaleana,http://goodpreview.info/trimaleana,142,142,0
11:04:2014,trimatol,http://goodpreview.info/trimatol,126,126,0
11:04:2014,trimblendgarciniacambogia,http://goodpreview.info/trimblendgarciniacambogia,77,79,-2
11:04:2014,triminexgarciniacambogia,http://goodpreview.info/triminexgarciniacambogia,97,98,-1
11:04:2014,triminexgreencoffee,http://goodpreview.info/triminexgreencoffee,59,62,-3
11:04:2014,tripleeffectseyeserum,http://goodpreview.info/tripleeffectseyeserum,620,621,-1
11:04:2014,turboextracut,http://goodpreview.info/turboextracut,162,162,0
11:04:2014,turboshred,http://goodpreview.info/turboshred,100,100,0
11:04:2014,ultimategarcinia,http://goodpreview.info/ultimategarcinia,165,165,0
11:04:2014,ultramaxtestosterone,http://goodpreview.info/ultramaxtestosterone,33,33,0
11:04:2014,ultrapurecoloncleanse,http://goodpreview.info/ultrapurecoloncleanse,7,8,-1
11:04:2014,ultraraspberryketone,http://goodpreview.info/ultraraspberryketone,419,420,-1
11:04:2014,velora,http://goodpreview.info/velora,23,23,0
11:04:2014,velveskin,http://goodpreview.info/velveskin,20,21,-1
11:04:2014,vencleanse,http://goodpreview.info/vencleanse,432,433,-1
11:04:2014,viarex,http://goodpreview.info/viarex,619,624,-5
11:04:2014,vitalifedetox,http://goodpreview.info/vitalifedetox,260,261,-1
11:04:2014,vitalitygreencoffee,http://goodpreview.info/vitalitygreencoffee,86,86,0
11:04:2014,vitamax,http://goodpreview.info/vitamax,22,25,-3
11:04:2014,vitolipo,http://goodpreview.info/vitolipo,1169,1172,-3
11:04:2014,vydox,http://goodpreview.info/vydox,328,328,0
11:04:2014,wildraspberryketone,http://goodpreview.info/wildraspberryketone,202,208,-6
11:04:2014,wrinklesscream,http://goodpreview.info/wrinklesscream,313,317,-4
11:04:2014,xenaslim,http://goodpreview.info/xenaslim,42,42,0
11:04:2014,xengthx1,http://goodpreview.info/xengthx1,38,43,-5
11:04:2014,xlerator,http://goodpreview.info/xlerator,0,0,0
11:04:2014,xocigs,http://goodpreview.info/xocigs,65,65,0
11:04:2014,xtgenix,http://goodpreview.info/xtgenix,13006,13013,-7
11:04:2014,xtrememusclepro,http://goodpreview.info/xtrememusclepro,616,616,0
11:04:2014,yaconsplash,http://goodpreview.info/yaconsplash,24,25,-1
11:04:2014,yaconsyruporiginal,http://goodpreview.info/yaconsyruporiginal,95,96,-1
11:04:2014,yaconsyrupsecret,http://goodpreview.info/yaconsyrupsecret,36,36,0
11:04:2014,yoloboost,http://goodpreview.info/yoloboost,21,25,-4
11:04:2014,youthkiteyecream,http://goodpreview.info/youthkiteyecream,246,246,0
