dt_today,sitetitle,sitelink,pre_click,new_clicks,difrnce
06:04:2014,11fruits,http://goodpreview.info/11fruits,200,200,0
06:04:2014,1285muscle,http://goodpreview.info/1285muscle,2864,2865,-1
06:04:2014,92trimgreencoffee,http://goodpreview.info/92trimgreencoffee,36,36,0
06:04:2014,Americig,http://goodpreview.info/Americig,435,442,-7
06:04:2014,Nuvagenic,http://goodpreview.info/Nuvagenic,1101,1101,0
06:04:2014,Prolexin,http://goodpreview.info/Prolexin,805,831,-26
06:04:2014,SVELME,http://goodpreview.info/SVELME,790,791,-1
06:04:2014,SlimSpray,http://goodpreview.info/SlimSpray,271,277,-6
06:04:2014,acaiberryfresh,http://goodpreview.info/acaiberryfresh,98,98,0
06:04:2014,acainatural,http://goodpreview.info/acainatural,132,133,-1
06:04:2014,acaiultralean,http://goodpreview.info/acaiultralean,130,131,-1
06:04:2014,advancedgarciniacambogia,http://goodpreview.info/advancedgarciniacambogia,884,884,0
06:04:2014,advancedgarciniacambogia-fr,http://goodpreview.info/advancedgarciniacambogia-fr,124,126,-2
06:04:2014,advancedgarciniacambogia1,http://goodpreview.info/advancedgarciniacambogia1,31,31,0
06:04:2014,advancedkrealkalyn,http://goodpreview.info/advancedkrealkalyn,146,146,0
06:04:2014,advancedpurecleanse,http://goodpreview.info/advancedpurecleanse,0,0,0
06:04:2014,advancedpurecleanse1,http://goodpreview.info/advancedpurecleanse1,31,32,-1
06:04:2014,africanmangoboost,http://goodpreview.info/africanmangoboost,118,118,0
06:04:2014,africanmangoprox,http://goodpreview.info/africanmangoprox,42,43,-1
06:04:2014,africanmangopure,http://goodpreview.info/africanmangopure,76,76,0
06:04:2014,aktiveam,http://goodpreview.info/aktiveam,1605,1606,-1
06:04:2014,aktivepm,http://goodpreview.info/aktivepm,2008,2017,-9
06:04:2014,alphajacked,http://goodpreview.info/alphajacked,772,773,-1
06:04:2014,alphamaxplus,http://goodpreview.info/alphamaxplus,16,16,0
06:04:2014,amazing,http://goodpreview.info/amazing,347,357,-10
06:04:2014,aminomuscle,http://goodpreview.info/aminomuscle,1199,1200,-1
06:04:2014,aminoprime,http://goodpreview.info/aminoprime,110,111,-1
06:04:2014,aminoprimexl,http://goodpreview.info/aminoprimexl,285,288,-3
06:04:2014,anabolicrx24,http://goodpreview.info/anabolicrx24,17933,18158,-225
06:04:2014,anatomyx5,http://goodpreview.info/anatomyx5,3,3,0
06:04:2014,androsolve,http://goodpreview.info/androsolve,1473,1477,-4
06:04:2014,androx,http://goodpreview.info/androx,13607,13709,-102
06:04:2014,anoradrol,http://goodpreview.info/anoradrol,216,217,-1
06:04:2014,auravie,http://goodpreview.info/auravie,104,104,0
06:04:2014,authenticgreencoffee,http://goodpreview.info/authenticgreencoffee,240,240,0
06:04:2014,beaudify,http://goodpreview.info/beaudify,73,73,0
06:04:2014,beautefxbbcream,http://goodpreview.info/beautefxbbcream,2,2,0
06:04:2014,beautynectarcollagen,http://goodpreview.info/beautynectarcollagen,132,133,-1
06:04:2014,beddefense,http://goodpreview.info/beddefense,27,27,0
06:04:2014,bellagenix,http://goodpreview.info/bellagenix,138,138,0
06:04:2014,bellalabs,http://goodpreview.info/bellalabs,8,8,0
06:04:2014,bellaplex,http://goodpreview.info/bellaplex,0,6,-6
06:04:2014,beriultimatepro,http://goodpreview.info/beriultimatepro,68,68,0
06:04:2014,berrythin,http://goodpreview.info/berrythin,326,330,-4
06:04:2014,betaalaninemax,http://goodpreview.info/betaalaninemax,0,0,0
06:04:2014,betaalaninextreme,http://goodpreview.info/betaalaninextreme,18,18,0
06:04:2014,beyondraspberry,http://goodpreview.info/beyondraspberry,75,75,0
06:04:2014,biohealthgarciniacambogia,http://goodpreview.info/biohealthgarciniacambogia,3540,3591,-51
06:04:2014,biomelt,http://goodpreview.info/biomelt,342,348,-6
06:04:2014,blastxl,http://goodpreview.info/blastxl,159,167,-8
06:04:2014,bodycleanseplus,http://goodpreview.info/bodycleanseplus,66,66,0
06:04:2014,bodywrap,http://goodpreview.info/bodywrap,207,207,0
06:04:2014,breakfree,http://goodpreview.info/breakfree,111,111,0
06:04:2014,cambogiatrim,http://goodpreview.info/cambogiatrim,598,598,0
06:04:2014,capsicum,http://goodpreview.info/capsicum,139,139,0
06:04:2014,celebritycleanser,http://goodpreview.info/celebritycleanser,104,135,-31
06:04:2014,celebrityraspberry,http://goodpreview.info/celebrityraspberry,140,144,-4
06:04:2014,cellanafricanmango,http://goodpreview.info/cellanafricanmango,255,259,-4
06:04:2014,cellogicaskin,http://goodpreview.info/cellogicaskin,50,50,0
06:04:2014,centrislim,http://goodpreview.info/centrislim,199,199,0
06:04:2014,certifiedgreencoffee,http://goodpreview.info/certifiedgreencoffee,149,149,0
06:04:2014,certifiedpuregreencoffee,http://goodpreview.info/certifiedpuregreencoffee,19,19,0
06:04:2014,chiocegreencoffee,http://goodpreview.info/chiocegreencoffee,545,545,0
06:04:2014,choicegreencoffee,http://goodpreview.info/choicegreencoffee,360,370,-10
06:04:2014,cleansefx,http://goodpreview.info/cleansefx,242,284,-42
06:04:2014,cleanseplus,http://goodpreview.info/cleanseplus,403,405,-2
06:04:2014,cleanseplus1,http://goodpreview.info/cleanseplus1,0,0,0
06:04:2014,cleansepremium,http://goodpreview.info/cleansepremium,15,15,0
06:04:2014,cleansewonder,http://goodpreview.info/cleansewonder,201,205,-4
06:04:2014,cleansextrem,http://goodpreview.info/cleansextrem,158,182,-24
06:04:2014,cleantrim,http://goodpreview.info/cleantrim,226,228,-2
06:04:2014,clearcleansepro,http://goodpreview.info/clearcleansepro,108,108,0
06:04:2014,clearsmoke,http://goodpreview.info/clearsmoke,177,177,0
06:04:2014,codered7,http://goodpreview.info/codered7,302,307,-5
06:04:2014,coleanse,http://goodpreview.info/coleanse,124,124,0
06:04:2014,collaton,http://goodpreview.info/collaton,88,88,0
06:04:2014,colocleansepro,http://goodpreview.info/colocleansepro,0,1,-1
06:04:2014,coloncleansetotal,http://goodpreview.info/coloncleansetotal,19,20,-1
06:04:2014,colonpurecleanse,http://goodpreview.info/colonpurecleanse,131,131,0
06:04:2014,colothin,http://goodpreview.info/colothin,989,989,0
06:04:2014,completecoffeecleanse,http://goodpreview.info/completecoffeecleanse,1982,1982,0
06:04:2014,complexiderm,http://goodpreview.info/complexiderm,103,105,-2
06:04:2014,corecutter,http://goodpreview.info/corecutter,36,38,-2
06:04:2014,csorex,http://goodpreview.info/csorex,174,179,-5
06:04:2014,dailyfacelift,http://goodpreview.info/dailyfacelift,95,99,-4
06:04:2014,dailyfacestemcelltechnology,http://goodpreview.info/dailyfacestemcelltechnology,195,196,-1
06:04:2014,dailypowercleanse,http://goodpreview.info/dailypowercleanse,116,118,-2
06:04:2014,deerantlerxtreme,http://goodpreview.info/deerantlerxtreme,131,131,0
06:04:2014,dermarose,http://goodpreview.info/dermarose,112,112,0
06:04:2014,dermaset,http://goodpreview.info/dermaset,51,51,0
06:04:2014,dermpure,http://goodpreview.info/dermpure,80,80,0
06:04:2014,dietgreencoffeebean,http://goodpreview.info/dietgreencoffeebean,310,312,-2
06:04:2014,drillpill,http://goodpreview.info/drillpill,455,457,-2
06:04:2014,elevategf,http://goodpreview.info/elevategf,174,174,0
06:04:2014,elier,http://goodpreview.info/elier,50,50,0
06:04:2014,elierskincare,http://goodpreview.info/elierskincare,41,41,0
06:04:2014,elitetest360,http://goodpreview.info/elitetest360,431,448,-17
06:04:2014,emeraldluxecig,http://goodpreview.info/emeraldluxecig,112,113,-1
06:04:2014,enduros,http://goodpreview.info/enduros,964,971,-7
06:04:2014,envigra,http://goodpreview.info/envigra,105,105,0
06:04:2014,estrodetox,http://goodpreview.info/estrodetox,99,99,0
06:04:2014,extentxl,http://goodpreview.info/extentxl,176,176,0
06:04:2014,fembalance,http://goodpreview.info/fembalance,17,17,0
06:04:2014,flawlessraspberryketone,http://goodpreview.info/flawlessraspberryketone,84,84,0
06:04:2014,formulat10,http://goodpreview.info/formulat10,1506,1508,-2
06:04:2014,garcinaiawow1,http://goodpreview.info/garcinaiawow1,51,57,-6
06:04:2014,garciniacambogia,http://goodpreview.info/garciniacambogia,211,254,-43
06:04:2014,garciniacambogia1000,http://goodpreview.info/garciniacambogia1000,62,62,0
06:04:2014,garciniacambogiaelite,http://goodpreview.info/garciniacambogiaelite,5247,5269,-22
06:04:2014,garciniacambogiafatbuster,http://goodpreview.info/garciniacambogiafatbuster,90,90,0
06:04:2014,garciniacambogiamax,http://goodpreview.info/garciniacambogiamax,2406,2408,-2
06:04:2014,garciniacambogiamiracle,http://goodpreview.info/garciniacambogiamiracle,129,129,0
06:04:2014,garciniacambogiapremium,http://goodpreview.info/garciniacambogiapremium,1075,1076,-1
06:04:2014,garciniacambogiapureextract,http://goodpreview.info/garciniacambogiapureextract,143,143,0
06:04:2014,garciniacambogiapureselect,http://goodpreview.info/garciniacambogiapureselect,596,596,0
06:04:2014,garciniacambogiasupreme,http://goodpreview.info/garciniacambogiasupreme,3162,3231,-69
06:04:2014,garciniacambogiatoday,http://goodpreview.info/garciniacambogiatoday,133,134,-1
06:04:2014,garciniacambogiaultra,http://goodpreview.info/garciniacambogiaultra,360,360,0
06:04:2014,garciniaforte,http://goodpreview.info/garciniaforte,26,45,-19
06:04:2014,garciniafreetrial,http://goodpreview.info/garciniafreetrial,67,68,-1
06:04:2014,garciniagreen,http://goodpreview.info/garciniagreen,836,837,-1
06:04:2014,garciniapureelite1,http://goodpreview.info/garciniapureelite1,1,1,0
06:04:2014,garciniatoday,http://goodpreview.info/garciniatoday,0,0,0
06:04:2014,garciniatotal,http://goodpreview.info/garciniatotal,90,92,-2
06:04:2014,garciniawow,http://goodpreview.info/garciniawow,911,949,-38
06:04:2014,garcinium,http://goodpreview.info/garcinium,56,11,45
06:04:2014,gc7x,http://goodpreview.info/gc7x,102,102,0
06:04:2014,gc7xgreencoffee,http://goodpreview.info/gc7xgreencoffee,0,0,0
06:04:2014,gcbultra,http://goodpreview.info/gcbultra,52,52,0
06:04:2014,gcbx,http://goodpreview.info/gcbx,17079,17082,-3
06:04:2014,gcbx1,http://goodpreview.info/gcbx1,196,196,0
06:04:2014,gcspeedslim,http://goodpreview.info/gcspeedslim,5731,5746,-15
06:04:2014,gcultra,http://goodpreview.info/gcultra,136,136,0
06:04:2014,gcultragarcinia,http://goodpreview.info/gcultragarcinia,4,4,0
06:04:2014,geneme,http://goodpreview.info/geneme,39,39,0
06:04:2014,getnaturalgarcinia,http://goodpreview.info/getnaturalgarcinia,40,40,0
06:04:2014,greencoffeeadvanced,http://goodpreview.info/greencoffeeadvanced,181,181,0
06:04:2014,greencoffeebean8000,http://goodpreview.info/greencoffeebean8000,66,66,0
06:04:2014,greencoffeebody,http://goodpreview.info/greencoffeebody,33,33,0
06:04:2014,greencoffeeburn,http://goodpreview.info/greencoffeeburn,24,25,-1
06:04:2014,greencoffeeextreme,http://goodpreview.info/greencoffeeextreme,84,84,0
06:04:2014,greencoffeemax,http://goodpreview.info/greencoffeemax,134,135,-1
06:04:2014,greencoffeemaxx,http://goodpreview.info/greencoffeemaxx,3,3,0
06:04:2014,greencoffeeoptimum,http://goodpreview.info/greencoffeeoptimum,122,122,0
06:04:2014,greencoffeeprogram,http://goodpreview.info/greencoffeeprogram,0,0,0
06:04:2014,greencoffeeultraslim,http://goodpreview.info/greencoffeeultraslim,206,206,0
06:04:2014,greentonepro,http://goodpreview.info/greentonepro,308,308,0
06:04:2014,healthetrimgarcinia,http://goodpreview.info/healthetrimgarcinia,151,151,0
06:04:2014,healthychoicegc,http://goodpreview.info/healthychoicegc,744,746,-2
06:04:2014,horsepowerplusxxxl,http://goodpreview.info/horsepowerplusxxxl,218,232,-14
06:04:2014,hugegenic,http://goodpreview.info/hugegenic,302,323,-21
06:04:2014,hydrellatone,http://goodpreview.info/hydrellatone,102,102,0
06:04:2014,hydrocollagen,http://goodpreview.info/hydrocollagen,43,44,-1
06:04:2014,hydroderm,http://goodpreview.info/hydroderm,43,46,-3
06:04:2014,hyperfuel9x,http://goodpreview.info/hyperfuel9x,1915,1921,-6
06:04:2014,illuminatedteeth,http://goodpreview.info/illuminatedteeth,41,41,0
06:04:2014,instantwrinklerepair,http://goodpreview.info/instantwrinklerepair,18,18,0
06:04:2014,iqderma,http://goodpreview.info/iqderma,415,418,-3
06:04:2014,iqdermaessen,http://goodpreview.info/iqdermaessen,0,0,0
06:04:2014,ketoneoptimum,http://goodpreview.info/ketoneoptimum,152,154,-2
06:04:2014,kleanslim,http://goodpreview.info/kleanslim,99,100,-1
06:04:2014,lacreme,http://goodpreview.info/lacreme,795,816,-21
06:04:2014,leanmuscleformula,http://goodpreview.info/leanmuscleformula,29,34,-5
06:04:2014,ledermeluxe,http://goodpreview.info/ledermeluxe,185,185,0
06:04:2014,leparfait,http://goodpreview.info/leparfait,16,21,-5
06:04:2014,leparisehydragold,http://goodpreview.info/leparisehydragold,3,3,0
06:04:2014,levela,http://goodpreview.info/levela,105,105,0
06:04:2014,lifedetox,http://goodpreview.info/lifedetox,145,145,0
06:04:2014,liftserumpro,http://goodpreview.info/liftserumpro,187,188,-1
06:04:2014,liposlender,http://goodpreview.info/liposlender,25,25,0
06:04:2014,liposlim,http://goodpreview.info/liposlim,1869,1874,-5
06:04:2014,liposom,http://goodpreview.info/liposom,61,62,-1
06:04:2014,liveskinny,http://goodpreview.info/liveskinny,232,232,0
06:04:2014,lumahydrate,http://goodpreview.info/lumahydrate,392,399,-7
06:04:2014,lumarepair,http://goodpreview.info/lumarepair,465,475,-10
06:04:2014,lunathin,http://goodpreview.info/lunathin,123,123,0
06:04:2014,luxoderm,http://goodpreview.info/luxoderm,203,209,-6
06:04:2014,lysocleanse,http://goodpreview.info/lysocleanse,1763,1782,-19
06:04:2014,maxdetoxpro,http://goodpreview.info/maxdetoxpro,574,574,0
06:04:2014,maxgarciniaburn,http://goodpreview.info/maxgarciniaburn,455,455,0
06:04:2014,maximumshred,http://goodpreview.info/maximumshred,1519,1522,-3
06:04:2014,maxrobust,http://goodpreview.info/maxrobust,254,257,-3
06:04:2014,maxrobustxtreme,http://goodpreview.info/maxrobustxtreme,521,521,0
06:04:2014,mightyraspberryketone,http://goodpreview.info/mightyraspberryketone,5105,5107,-2
06:04:2014,miraclegarciniacambogia,http://goodpreview.info/miraclegarciniacambogia,481,487,-6
06:04:2014,miraclegreencoffee,http://goodpreview.info/miraclegreencoffee,515,529,-14
06:04:2014,miraclesaffron,http://goodpreview.info/miraclesaffron,48,50,-2
06:04:2014,mitoslim,http://goodpreview.info/mitoslim,2055,2055,0
06:04:2014,musclefactorx,http://goodpreview.info/musclefactorx,1439,1440,-1
06:04:2014,musclefactorx-1,http://goodpreview.info/musclefactorx-1,22,22,0
06:04:2014,musclekingpro,http://goodpreview.info/musclekingpro,501,501,0
06:04:2014,musclemaxextreme,http://goodpreview.info/musclemaxextreme,137,137,0
06:04:2014,muscleplus,http://goodpreview.info/muscleplus,141,142,-1
06:04:2014,musclerevolutionpro,http://goodpreview.info/musclerevolutionpro,1403,1411,-8
06:04:2014,musclerevx,http://goodpreview.info/musclerevx,89,91,-2
06:04:2014,musclerevxtreme,http://goodpreview.info/musclerevxtreme,58,58,0
06:04:2014,musclexlerator,http://goodpreview.info/musclexlerator,24,26,-2
06:04:2014,musclexmax,http://goodpreview.info/musclexmax,1426,1436,-10
06:04:2014,musclexmax1,http://goodpreview.info/musclexmax1,278,278,0
06:04:2014,musclezx90,http://goodpreview.info/musclezx90,4969,4974,-5
06:04:2014,naturalcleanse,http://goodpreview.info/naturalcleanse,8003,8018,-15
06:04:2014,naturalgarciniacambogia,http://goodpreview.info/naturalgarciniacambogia,2764,2767,-3
06:04:2014,naturalgreencoffee,http://goodpreview.info/naturalgreencoffee,8,8,0
06:04:2014,naturalhealthgarcinia,http://goodpreview.info/naturalhealthgarcinia,50,52,-2
06:04:2014,naturalpurecleanse,http://goodpreview.info/naturalpurecleanse,1548,1558,-10
06:04:2014,nauseam,http://goodpreview.info/nauseam,135,135,0
06:04:2014,nauseamplus,http://goodpreview.info/nauseamplus,0,0,0
06:04:2014,nextrim,http://goodpreview.info/nextrim,1724,1730,-6
06:04:2014,nitricmusclemax,http://goodpreview.info/nitricmusclemax,13637,13836,-199
06:04:2014,nitrofocusno3,http://goodpreview.info/nitrofocusno3,83,85,-2
06:04:2014,niwali,http://goodpreview.info/niwali,807,813,-6
06:04:2014,no2explodeextreme,http://goodpreview.info/no2explodeextreme,161,162,-1
06:04:2014,no2extremerush,http://goodpreview.info/no2extremerush,1300,1301,-1
06:04:2014,noflameecigs,http://goodpreview.info/noflameecigs,350,350,0
06:04:2014,nuclearno,http://goodpreview.info/nuclearno,367,367,0
06:04:2014,nuetrim,http://goodpreview.info/nuetrim,659,660,-1
06:04:2014,nutragreencoffee,http://goodpreview.info/nutragreencoffee,3557,3564,-7
06:04:2014,nutrapuregarcinia,http://goodpreview.info/nutrapuregarcinia,209,211,-2
06:04:2014,nutratoneplus,http://goodpreview.info/nutratoneplus,1001,1003,-2
06:04:2014,nutriberryslim,http://goodpreview.info/nutriberryslim,1120,1140,-20
06:04:2014,nuvoryn,http://goodpreview.info/nuvoryn,22,22,0
06:04:2014,optimalstack,http://goodpreview.info/optimalstack,1651,1653,-2
06:04:2014,optimummuscle,http://goodpreview.info/optimummuscle,205,207,-2
06:04:2014,organicgreencoffee,http://goodpreview.info/organicgreencoffee,90,91,-1
06:04:2014,organicwhitekidneybean,http://goodpreview.info/organicwhitekidneybean,91,91,0
06:04:2014,orviax,http://goodpreview.info/orviax,89,89,0
06:04:2014,oxitamin,http://goodpreview.info/oxitamin,147,147,0
06:04:2014,phtytoceramides,http://goodpreview.info/phtytoceramides,807,816,-9
06:04:2014,powerigf,http://goodpreview.info/powerigf,1795,1816,-21
06:04:2014,powerpumpxl,http://goodpreview.info/powerpumpxl,367,369,-2
06:04:2014,powerup,http://goodpreview.info/powerup,118,119,-1
06:04:2014,premiermangocleanse,http://goodpreview.info/premiermangocleanse,513,513,0
06:04:2014,premiumcleanse,http://goodpreview.info/premiumcleanse,2748,2760,-12
06:04:2014,premiumgarciniacambogia,http://goodpreview.info/premiumgarciniacambogia,400,401,-1
06:04:2014,premiumgarciniaextract,http://goodpreview.info/premiumgarciniaextract,710,713,-3
06:04:2014,premiumgreencoffee,http://goodpreview.info/premiumgreencoffee,119,119,0
06:04:2014,premiumgreencoffee800,http://goodpreview.info/premiumgreencoffee800,108,108,0
06:04:2014,premiumraspberryketone,http://goodpreview.info/premiumraspberryketone,43,43,0
06:04:2014,primalitegarciniaextract,http://goodpreview.info/primalitegarciniaextract,722,735,-13
06:04:2014,progain350,http://goodpreview.info/progain350,226,231,-5
06:04:2014,prograce,http://goodpreview.info/prograce,3,3,0
06:04:2014,promusclecomplex,http://goodpreview.info/promusclecomplex,49,49,0
06:04:2014,propowercleanse,http://goodpreview.info/propowercleanse,1044,1094,-50
06:04:2014,pureberrymax,http://goodpreview.info/pureberrymax,215,215,0
06:04:2014,purecleansehealth,http://goodpreview.info/purecleansehealth,107,110,-3
06:04:2014,purecollagen,http://goodpreview.info/purecollagen,2223,2225,-2
06:04:2014,puregarciniacambogia,http://goodpreview.info/puregarciniacambogia,1209,1212,-3
06:04:2014,puregarciniaslim,http://goodpreview.info/puregarciniaslim,165,167,-2
06:04:2014,puregreencoffeebeanextract,http://goodpreview.info/puregreencoffeebeanextract,2712,2714,-2
06:04:2014,puregreencoffeemaxima,http://goodpreview.info/puregreencoffeemaxima,37,37,0
06:04:2014,puregriffonia,http://goodpreview.info/puregriffonia,96,96,0
06:04:2014,pureketoneslim,http://goodpreview.info/pureketoneslim,32,32,0
06:04:2014,purelifeclanse,http://goodpreview.info/purelifeclanse,6,9,-3
06:04:2014,puremusclepro,http://goodpreview.info/puremusclepro,1802,1808,-6
06:04:2014,purenaturalcleanser,http://goodpreview.info/purenaturalcleanser,477,477,0
06:04:2014,purephytoceramides,http://goodpreview.info/purephytoceramides,74,74,0
06:04:2014,pureraspberryketonepremium,http://goodpreview.info/pureraspberryketonepremium,63,63,0
06:04:2014,puresaffronslim,http://goodpreview.info/puresaffronslim,423,423,0
06:04:2014,pureslim57,http://goodpreview.info/pureslim57,126,126,0
06:04:2014,purgarciniacambogia,http://goodpreview.info/purgarciniacambogia,157,157,0
06:04:2014,purgreencoffee,http://goodpreview.info/purgreencoffee,1626,1626,0
06:04:2014,purifyre,http://goodpreview.info/purifyre,244,244,0
06:04:2014,purifyregreencoffee,http://goodpreview.info/purifyregreencoffee,0,0,0
06:04:2014,raspberryhealth,http://goodpreview.info/raspberryhealth,61,63,-2
06:04:2014,raspberryketoneblast,http://goodpreview.info/raspberryketoneblast,4194,4238,-44
06:04:2014,raspberryketoned,http://goodpreview.info/raspberryketoned,2,2,0
06:04:2014,raspberryketoneoptimum,http://goodpreview.info/raspberryketoneoptimum,5,5,0
06:04:2014,raspberryketonepremium,http://goodpreview.info/raspberryketonepremium,79,79,0
06:04:2014,raspberryketonepure,http://goodpreview.info/raspberryketonepure,2,2,0
06:04:2014,raspberryketonethin,http://goodpreview.info/raspberryketonethin,18,26,-8
06:04:2014,raspberryslimplus,http://goodpreview.info/raspberryslimplus,127,127,0
06:04:2014,refuelextreme,http://goodpreview.info/refuelextreme,488,492,-4
06:04:2014,regalecig,http://goodpreview.info/regalecig,372,372,0
06:04:2014,regalecigs,http://goodpreview.info/regalecigs,41,41,0
06:04:2014,rejuvaglow,http://goodpreview.info/rejuvaglow,71,71,0
06:04:2014,rejuveneyemax,http://goodpreview.info/rejuveneyemax,55,73,-18
06:04:2014,rellift,http://goodpreview.info/rellift,29,29,0
06:04:2014,renovo,http://goodpreview.info/renovo,37,38,-1
06:04:2014,restiflex,http://goodpreview.info/restiflex,63,63,0
06:04:2014,revitalize,http://goodpreview.info/revitalize,25,25,0
06:04:2014,revitatone,http://goodpreview.info/revitatone,8907,8961,-54
06:04:2014,revolutionaryraspberryketone,http://goodpreview.info/revolutionaryraspberryketone,65,65,0
06:04:2014,revoreplex,http://goodpreview.info/revoreplex,9,9,0
06:04:2014,revtesttestosterone,http://goodpreview.info/revtesttestosterone,1593,1593,0
06:04:2014,rippedmusclex,http://goodpreview.info/rippedmusclex,187,191,-4
06:04:2014,rippedxburn,http://goodpreview.info/rippedxburn,185,186,-1
06:04:2014,sacredarganoil,http://goodpreview.info/sacredarganoil,48,49,-1
06:04:2014,safercolon,http://goodpreview.info/safercolon,3090,3163,-73
06:04:2014,saffronextractpremium,http://goodpreview.info/saffronextractpremium,105,105,0
06:04:2014,saffronextractselect,http://goodpreview.info/saffronextractselect,1365,1368,-3
06:04:2014,saffronselect,http://goodpreview.info/saffronselect,72,74,-2
06:04:2014,secretgreencoffee,http://goodpreview.info/secretgreencoffee,262,263,-1
06:04:2014,simpleantiaging,http://goodpreview.info/simpleantiaging,230,231,-1
06:04:2014,simplygarcinia,http://goodpreview.info/simplygarcinia,1102,1116,-14
06:04:2014,skinlift,http://goodpreview.info/skinlift,2147,2147,0
06:04:2014,slendera,http://goodpreview.info/slendera,15,15,0
06:04:2014,slenderagc-1,http://goodpreview.info/slenderagc-1,401,403,-2
06:04:2014,slimatrex,http://goodpreview.info/slimatrex,617,618,-1
06:04:2014,slimhelper,http://goodpreview.info/slimhelper,246,246,0
06:04:2014,slimher,http://goodpreview.info/slimher,171,171,0
06:04:2014,slimmeryougarcinia,http://goodpreview.info/slimmeryougarcinia,0,0,0
06:04:2014,slimtropical,http://goodpreview.info/slimtropical,807,808,-1
06:04:2014,slimtropicalmx,http://goodpreview.info/slimtropicalmx,135,135,0
06:04:2014,slimzenu,http://goodpreview.info/slimzenu,201,201,0
06:04:2014,smokestarecig,http://goodpreview.info/smokestarecig,549,553,-4
06:04:2014,solpriaxtreme,http://goodpreview.info/solpriaxtreme,2783,2784,-1
06:04:2014,sorepressin,http://goodpreview.info/sorepressin,6,6,0
06:04:2014,speedtrimxs,http://goodpreview.info/speedtrimxs,95,95,0
06:04:2014,splendyr,http://goodpreview.info/splendyr,1274,1275,-1
06:04:2014,splendyrantiaging,http://goodpreview.info/splendyrantiaging,51,51,0
06:04:2014,superacaicleanse,http://goodpreview.info/superacaicleanse,21,21,0
06:04:2014,supercleansetotal,http://goodpreview.info/supercleansetotal,69,71,-2
06:04:2014,supergreencoffee,http://goodpreview.info/supergreencoffee,11,11,0
06:04:2014,supergreencoffeebean,http://goodpreview.info/supergreencoffeebean,20,20,0
06:04:2014,superiormusclex,http://goodpreview.info/superiormusclex,5,14,-9
06:04:2014,superiorvelvet,http://goodpreview.info/superiorvelvet,1,1,0
06:04:2014,superyacon1000,http://goodpreview.info/superyacon1000,20,21,-1
06:04:2014,supracleanse350,http://goodpreview.info/supracleanse350,0,0,0
06:04:2014,supragreencoffee,http://goodpreview.info/supragreencoffee,916,923,-7
06:04:2014,supragreencoffeebean,http://goodpreview.info/supragreencoffeebean,0,0,0
06:04:2014,surelyyoung,http://goodpreview.info/surelyyoung,29,29,0
06:04:2014,swissrose,http://goodpreview.info/swissrose,341,341,0
06:04:2014,swolekreate,http://goodpreview.info/swolekreate,192,193,-1
06:04:2014,syneocell,http://goodpreview.info/syneocell,56,56,0
06:04:2014,t-force,http://goodpreview.info/t-force,193,196,-3
06:04:2014,testforcextreme,http://goodpreview.info/testforcextreme,491,491,0
06:04:2014,testoforce,http://goodpreview.info/testoforce,21,21,0
06:04:2014,testorushrx,http://goodpreview.info/testorushrx,40,41,-1
06:04:2014,testosteronemax,http://goodpreview.info/testosteronemax,329,329,0
06:04:2014,testoxl,http://goodpreview.info/testoxl,1478,1478,0
06:04:2014,thinmagic,http://goodpreview.info/thinmagic,272,272,0
06:04:2014,thinmagicmax,http://goodpreview.info/thinmagicmax,0,0,0
06:04:2014,thinsport,http://goodpreview.info/thinsport,211,212,-1
06:04:2014,titaniumprox,http://goodpreview.info/titaniumprox,0,0,0
06:04:2014,totalbodyfresh,http://goodpreview.info/totalbodyfresh,115,124,-9
06:04:2014,trigx2,http://goodpreview.info/trigx2,11,14,-3
06:04:2014,trimaleana,http://goodpreview.info/trimaleana,142,142,0
06:04:2014,trimatol,http://goodpreview.info/trimatol,123,123,0
06:04:2014,trimblendgarciniacambogia,http://goodpreview.info/trimblendgarciniacambogia,75,76,-1
06:04:2014,triminexgarciniacambogia,http://goodpreview.info/triminexgarciniacambogia,89,90,-1
06:04:2014,triminexgreencoffee,http://goodpreview.info/triminexgreencoffee,55,56,-1
06:04:2014,tripleeffectseyeserum,http://goodpreview.info/tripleeffectseyeserum,608,613,-5
06:04:2014,turboextracut,http://goodpreview.info/turboextracut,161,162,-1
06:04:2014,turboshred,http://goodpreview.info/turboshred,100,100,0
06:04:2014,ultimategarcinia,http://goodpreview.info/ultimategarcinia,164,165,-1
06:04:2014,ultramaxtestosterone,http://goodpreview.info/ultramaxtestosterone,33,33,0
06:04:2014,ultrapurecoloncleanse,http://goodpreview.info/ultrapurecoloncleanse,4,4,0
06:04:2014,ultraraspberryketone,http://goodpreview.info/ultraraspberryketone,418,418,0
06:04:2014,velora,http://goodpreview.info/velora,23,23,0
06:04:2014,velveskin,http://goodpreview.info/velveskin,17,17,0
06:04:2014,vencleanse,http://goodpreview.info/vencleanse,431,431,0
06:04:2014,viarex,http://goodpreview.info/viarex,600,605,-5
06:04:2014,vitalifedetox,http://goodpreview.info/vitalifedetox,257,257,0
06:04:2014,vitalitygreencoffee,http://goodpreview.info/vitalitygreencoffee,85,85,0
06:04:2014,vitamax,http://goodpreview.info/vitamax,22,22,0
06:04:2014,vitolipo,http://goodpreview.info/vitolipo,1141,1148,-7
06:04:2014,vydox,http://goodpreview.info/vydox,310,313,-3
06:04:2014,wildraspberryketone,http://goodpreview.info/wildraspberryketone,178,182,-4
06:04:2014,wrinklesscream,http://goodpreview.info/wrinklesscream,282,291,-9
06:04:2014,xenaslim,http://goodpreview.info/xenaslim,41,41,0
06:04:2014,xengthx1,http://goodpreview.info/xengthx1,32,34,-2
06:04:2014,xlerator,http://goodpreview.info/xlerator,0,0,0
06:04:2014,xocigs,http://goodpreview.info/xocigs,65,65,0
06:04:2014,xtgenix,http://goodpreview.info/xtgenix,12958,12963,-5
06:04:2014,xtrememusclepro,http://goodpreview.info/xtrememusclepro,610,610,0
06:04:2014,yaconsplash,http://goodpreview.info/yaconsplash,21,21,0
06:04:2014,yaconsyruporiginal,http://goodpreview.info/yaconsyruporiginal,95,95,0
06:04:2014,yaconsyrupsecret,http://goodpreview.info/yaconsyrupsecret,34,34,0
06:04:2014,yoloboost,http://goodpreview.info/yoloboost,3,5,-2
06:04:2014,youthkiteyecream,http://goodpreview.info/youthkiteyecream,244,245,-1
