dt_today,sitetitle,sitelink,pre_click,new_clicks,difrnce
05:04:2014,11fruits,http://goodpreview.info/11fruits,200,200,0
05:04:2014,1285muscle,http://goodpreview.info/1285muscle,2861,2864,-3
05:04:2014,92trimgreencoffee,http://goodpreview.info/92trimgreencoffee,35,36,-1
05:04:2014,Americig,http://goodpreview.info/Americig,426,435,-9
05:04:2014,Nuvagenic,http://goodpreview.info/Nuvagenic,1101,1101,0
05:04:2014,Prolexin,http://goodpreview.info/Prolexin,777,805,-28
05:04:2014,SVELME,http://goodpreview.info/SVELME,790,790,0
05:04:2014,SlimSpray,http://goodpreview.info/SlimSpray,269,271,-2
05:04:2014,acaiberryfresh,http://goodpreview.info/acaiberryfresh,98,98,0
05:04:2014,acainatural,http://goodpreview.info/acainatural,132,132,0
05:04:2014,acaiultralean,http://goodpreview.info/acaiultralean,129,130,-1
05:04:2014,advancedgarciniacambogia,http://goodpreview.info/advancedgarciniacambogia,884,884,0
05:04:2014,advancedgarciniacambogia-fr,http://goodpreview.info/advancedgarciniacambogia-fr,119,124,-5
05:04:2014,advancedgarciniacambogia1,http://goodpreview.info/advancedgarciniacambogia1,26,31,-5
05:04:2014,advancedkrealkalyn,http://goodpreview.info/advancedkrealkalyn,146,146,0
05:04:2014,advancedpurecleanse,http://goodpreview.info/advancedpurecleanse,0,0,0
05:04:2014,advancedpurecleanse1,http://goodpreview.info/advancedpurecleanse1,27,31,-4
05:04:2014,africanmangoboost,http://goodpreview.info/africanmangoboost,118,118,0
05:04:2014,africanmangoprox,http://goodpreview.info/africanmangoprox,42,42,0
05:04:2014,africanmangopure,http://goodpreview.info/africanmangopure,76,76,0
05:04:2014,aktiveam,http://goodpreview.info/aktiveam,1604,1605,-1
05:04:2014,aktivepm,http://goodpreview.info/aktivepm,2002,2008,-6
05:04:2014,alphajacked,http://goodpreview.info/alphajacked,772,772,0
05:04:2014,alphamaxplus,http://goodpreview.info/alphamaxplus,14,16,-2
05:04:2014,amazing,http://goodpreview.info/amazing,330,347,-17
05:04:2014,aminomuscle,http://goodpreview.info/aminomuscle,1195,1199,-4
05:04:2014,aminoprime,http://goodpreview.info/aminoprime,110,110,0
05:04:2014,aminoprimexl,http://goodpreview.info/aminoprimexl,284,285,-1
05:04:2014,anabolicrx24,http://goodpreview.info/anabolicrx24,17659,17933,-274
05:04:2014,anatomyx5,http://goodpreview.info/anatomyx5,3,3,0
05:04:2014,androsolve,http://goodpreview.info/androsolve,1473,1473,0
05:04:2014,androx,http://goodpreview.info/androx,13465,13607,-142
05:04:2014,anoradrol,http://goodpreview.info/anoradrol,215,216,-1
05:04:2014,auravie,http://goodpreview.info/auravie,104,104,0
05:04:2014,authenticgreencoffee,http://goodpreview.info/authenticgreencoffee,240,240,0
05:04:2014,beaudify,http://goodpreview.info/beaudify,73,73,0
05:04:2014,beautefxbbcream,http://goodpreview.info/beautefxbbcream,2,2,0
05:04:2014,beautynectarcollagen,http://goodpreview.info/beautynectarcollagen,132,132,0
05:04:2014,beddefense,http://goodpreview.info/beddefense,27,27,0
05:04:2014,bellagenix,http://goodpreview.info/bellagenix,138,138,0
05:04:2014,bellalabs,http://goodpreview.info/bellalabs,8,8,0
05:04:2014,bellaplex,http://goodpreview.info/bellaplex,0,0,0
05:04:2014,beriultimatepro,http://goodpreview.info/beriultimatepro,68,68,0
05:04:2014,berrythin,http://goodpreview.info/berrythin,325,326,-1
05:04:2014,betaalaninemax,http://goodpreview.info/betaalaninemax,0,0,0
05:04:2014,betaalaninextreme,http://goodpreview.info/betaalaninextreme,16,18,-2
05:04:2014,beyondraspberry,http://goodpreview.info/beyondraspberry,75,75,0
05:04:2014,biohealthgarciniacambogia,http://goodpreview.info/biohealthgarciniacambogia,3502,3540,-38
05:04:2014,biomelt,http://goodpreview.info/biomelt,340,342,-2
05:04:2014,blastxl,http://goodpreview.info/blastxl,156,159,-3
05:04:2014,bodycleanseplus,http://goodpreview.info/bodycleanseplus,66,66,0
05:04:2014,bodywrap,http://goodpreview.info/bodywrap,207,207,0
05:04:2014,breakfree,http://goodpreview.info/breakfree,111,111,0
05:04:2014,cambogiatrim,http://goodpreview.info/cambogiatrim,598,598,0
05:04:2014,capsicum,http://goodpreview.info/capsicum,139,139,0
05:04:2014,celebritycleanser,http://goodpreview.info/celebritycleanser,94,104,-10
05:04:2014,celebrityraspberry,http://goodpreview.info/celebrityraspberry,137,140,-3
05:04:2014,cellanafricanmango,http://goodpreview.info/cellanafricanmango,250,255,-5
05:04:2014,cellogicaskin,http://goodpreview.info/cellogicaskin,50,50,0
05:04:2014,centrislim,http://goodpreview.info/centrislim,199,199,0
05:04:2014,certifiedgreencoffee,http://goodpreview.info/certifiedgreencoffee,149,149,0
05:04:2014,certifiedpuregreencoffee,http://goodpreview.info/certifiedpuregreencoffee,19,19,0
05:04:2014,chiocegreencoffee,http://goodpreview.info/chiocegreencoffee,545,545,0
05:04:2014,choicegreencoffee,http://goodpreview.info/choicegreencoffee,352,360,-8
05:04:2014,cleansefx,http://goodpreview.info/cleansefx,199,242,-43
05:04:2014,cleanseplus,http://goodpreview.info/cleanseplus,384,403,-19
05:04:2014,cleanseplus1,http://goodpreview.info/cleanseplus1,0,0,0
05:04:2014,cleansepremium,http://goodpreview.info/cleansepremium,15,15,0
05:04:2014,cleansewonder,http://goodpreview.info/cleansewonder,200,201,-1
05:04:2014,cleansextrem,http://goodpreview.info/cleansextrem,122,158,-36
05:04:2014,cleantrim,http://goodpreview.info/cleantrim,226,226,0
05:04:2014,clearcleansepro,http://goodpreview.info/clearcleansepro,108,108,0
05:04:2014,clearsmoke,http://goodpreview.info/clearsmoke,176,177,-1
05:04:2014,codered7,http://goodpreview.info/codered7,301,302,-1
05:04:2014,coleanse,http://goodpreview.info/coleanse,124,124,0
05:04:2014,collaton,http://goodpreview.info/collaton,88,88,0
05:04:2014,colocleansepro,http://goodpreview.info/colocleansepro,0,0,0
05:04:2014,coloncleansetotal,http://goodpreview.info/coloncleansetotal,16,19,-3
05:04:2014,colonpurecleanse,http://goodpreview.info/colonpurecleanse,131,131,0
05:04:2014,colothin,http://goodpreview.info/colothin,988,989,-1
05:04:2014,completecoffeecleanse,http://goodpreview.info/completecoffeecleanse,1981,1982,-1
05:04:2014,complexiderm,http://goodpreview.info/complexiderm,103,103,0
05:04:2014,corecutter,http://goodpreview.info/corecutter,35,36,-1
05:04:2014,csorex,http://goodpreview.info/csorex,174,174,0
05:04:2014,dailyfacelift,http://goodpreview.info/dailyfacelift,92,95,-3
05:04:2014,dailyfacestemcelltechnology,http://goodpreview.info/dailyfacestemcelltechnology,193,195,-2
05:04:2014,dailypowercleanse,http://goodpreview.info/dailypowercleanse,114,116,-2
05:04:2014,deerantlerxtreme,http://goodpreview.info/deerantlerxtreme,131,131,0
05:04:2014,dermarose,http://goodpreview.info/dermarose,112,112,0
05:04:2014,dermaset,http://goodpreview.info/dermaset,51,51,0
05:04:2014,dermpure,http://goodpreview.info/dermpure,80,80,0
05:04:2014,dietgreencoffeebean,http://goodpreview.info/dietgreencoffeebean,310,310,0
05:04:2014,drillpill,http://goodpreview.info/drillpill,455,455,0
05:04:2014,elevategf,http://goodpreview.info/elevategf,174,174,0
05:04:2014,elier,http://goodpreview.info/elier,50,50,0
05:04:2014,elierskincare,http://goodpreview.info/elierskincare,40,41,-1
05:04:2014,elitetest360,http://goodpreview.info/elitetest360,419,431,-12
05:04:2014,emeraldluxecig,http://goodpreview.info/emeraldluxecig,112,112,0
05:04:2014,enduros,http://goodpreview.info/enduros,957,964,-7
05:04:2014,envigra,http://goodpreview.info/envigra,105,105,0
05:04:2014,estrodetox,http://goodpreview.info/estrodetox,98,99,-1
05:04:2014,extentxl,http://goodpreview.info/extentxl,175,176,-1
05:04:2014,fembalance,http://goodpreview.info/fembalance,17,17,0
05:04:2014,flawlessraspberryketone,http://goodpreview.info/flawlessraspberryketone,80,84,-4
05:04:2014,formulat10,http://goodpreview.info/formulat10,1505,1506,-1
05:04:2014,garcinaiawow1,http://goodpreview.info/garcinaiawow1,43,51,-8
05:04:2014,garciniacambogia,http://goodpreview.info/garciniacambogia,182,211,-29
05:04:2014,garciniacambogia1000,http://goodpreview.info/garciniacambogia1000,62,62,0
05:04:2014,garciniacambogiaelite,http://goodpreview.info/garciniacambogiaelite,5228,5247,-19
05:04:2014,garciniacambogiafatbuster,http://goodpreview.info/garciniacambogiafatbuster,90,90,0
05:04:2014,garciniacambogiamax,http://goodpreview.info/garciniacambogiamax,2405,2406,-1
05:04:2014,garciniacambogiamiracle,http://goodpreview.info/garciniacambogiamiracle,128,129,-1
05:04:2014,garciniacambogiapremium,http://goodpreview.info/garciniacambogiapremium,1075,1075,0
05:04:2014,garciniacambogiapureextract,http://goodpreview.info/garciniacambogiapureextract,141,143,-2
05:04:2014,garciniacambogiapureselect,http://goodpreview.info/garciniacambogiapureselect,594,596,-2
05:04:2014,garciniacambogiasupreme,http://goodpreview.info/garciniacambogiasupreme,3050,3162,-112
05:04:2014,garciniacambogiatoday,http://goodpreview.info/garciniacambogiatoday,126,133,-7
05:04:2014,garciniacambogiaultra,http://goodpreview.info/garciniacambogiaultra,358,360,-2
05:04:2014,garciniaforte,http://goodpreview.info/garciniaforte,11,26,-15
05:04:2014,garciniafreetrial,http://goodpreview.info/garciniafreetrial,67,67,0
05:04:2014,garciniagreen,http://goodpreview.info/garciniagreen,834,836,-2
05:04:2014,garciniapureelite1,http://goodpreview.info/garciniapureelite1,1,1,0
05:04:2014,garciniatoday,http://goodpreview.info/garciniatoday,0,0,0
05:04:2014,garciniatotal,http://goodpreview.info/garciniatotal,89,90,-1
05:04:2014,garciniawow,http://goodpreview.info/garciniawow,870,911,-41
05:04:2014,garcinium,http://goodpreview.info/garcinium,33,56,-23
05:04:2014,gc7x,http://goodpreview.info/gc7x,102,102,0
05:04:2014,gc7xgreencoffee,http://goodpreview.info/gc7xgreencoffee,0,0,0
05:04:2014,gcbultra,http://goodpreview.info/gcbultra,52,52,0
05:04:2014,gcbx,http://goodpreview.info/gcbx,17077,17079,-2
05:04:2014,gcbx1,http://goodpreview.info/gcbx1,196,196,0
05:04:2014,gcspeedslim,http://goodpreview.info/gcspeedslim,5715,5731,-16
05:04:2014,gcultra,http://goodpreview.info/gcultra,135,136,-1
05:04:2014,gcultragarcinia,http://goodpreview.info/gcultragarcinia,4,4,0
05:04:2014,geneme,http://goodpreview.info/geneme,39,39,0
05:04:2014,getnaturalgarcinia,http://goodpreview.info/getnaturalgarcinia,40,40,0
05:04:2014,greencoffeeadvanced,http://goodpreview.info/greencoffeeadvanced,181,181,0
05:04:2014,greencoffeebean8000,http://goodpreview.info/greencoffeebean8000,66,66,0
05:04:2014,greencoffeebody,http://goodpreview.info/greencoffeebody,33,33,0
05:04:2014,greencoffeeburn,http://goodpreview.info/greencoffeeburn,24,24,0
05:04:2014,greencoffeeextreme,http://goodpreview.info/greencoffeeextreme,84,84,0
05:04:2014,greencoffeemax,http://goodpreview.info/greencoffeemax,130,134,-4
05:04:2014,greencoffeemaxx,http://goodpreview.info/greencoffeemaxx,3,3,0
05:04:2014,greencoffeeoptimum,http://goodpreview.info/greencoffeeoptimum,122,122,0
05:04:2014,greencoffeeprogram,http://goodpreview.info/greencoffeeprogram,0,0,0
05:04:2014,greencoffeeultraslim,http://goodpreview.info/greencoffeeultraslim,206,206,0
05:04:2014,greentonepro,http://goodpreview.info/greentonepro,308,308,0
05:04:2014,healthetrimgarcinia,http://goodpreview.info/healthetrimgarcinia,151,151,0
05:04:2014,healthychoicegc,http://goodpreview.info/healthychoicegc,741,744,-3
05:04:2014,horsepowerplusxxxl,http://goodpreview.info/horsepowerplusxxxl,192,218,-26
05:04:2014,hugegenic,http://goodpreview.info/hugegenic,292,302,-10
05:04:2014,hydrellatone,http://goodpreview.info/hydrellatone,102,102,0
05:04:2014,hydrocollagen,http://goodpreview.info/hydrocollagen,43,43,0
05:04:2014,hydroderm,http://goodpreview.info/hydroderm,43,43,0
05:04:2014,hyperfuel9x,http://goodpreview.info/hyperfuel9x,1909,1915,-6
05:04:2014,illuminatedteeth,http://goodpreview.info/illuminatedteeth,40,41,-1
05:04:2014,instantwrinklerepair,http://goodpreview.info/instantwrinklerepair,18,18,0
05:04:2014,iqderma,http://goodpreview.info/iqderma,413,415,-2
05:04:2014,iqdermaessen,http://goodpreview.info/iqdermaessen,0,0,0
05:04:2014,ketoneoptimum,http://goodpreview.info/ketoneoptimum,151,152,-1
05:04:2014,kleanslim,http://goodpreview.info/kleanslim,99,99,0
05:04:2014,lacreme,http://goodpreview.info/lacreme,781,795,-14
05:04:2014,leanmuscleformula,http://goodpreview.info/leanmuscleformula,25,29,-4
05:04:2014,ledermeluxe,http://goodpreview.info/ledermeluxe,185,185,0
05:04:2014,leparfait,http://goodpreview.info/leparfait,16,16,0
05:04:2014,leparisehydragold,http://goodpreview.info/leparisehydragold,1,3,-2
05:04:2014,levela,http://goodpreview.info/levela,105,105,0
05:04:2014,lifedetox,http://goodpreview.info/lifedetox,145,145,0
05:04:2014,liftserumpro,http://goodpreview.info/liftserumpro,186,187,-1
05:04:2014,liposlender,http://goodpreview.info/liposlender,24,25,-1
05:04:2014,liposlim,http://goodpreview.info/liposlim,1865,1869,-4
05:04:2014,liposom,http://goodpreview.info/liposom,61,61,0
05:04:2014,liveskinny,http://goodpreview.info/liveskinny,232,232,0
05:04:2014,lumahydrate,http://goodpreview.info/lumahydrate,379,392,-13
05:04:2014,lumarepair,http://goodpreview.info/lumarepair,457,465,-8
05:04:2014,lunathin,http://goodpreview.info/lunathin,122,123,-1
05:04:2014,luxoderm,http://goodpreview.info/luxoderm,198,203,-5
05:04:2014,lysocleanse,http://goodpreview.info/lysocleanse,1750,1763,-13
05:04:2014,maxdetoxpro,http://goodpreview.info/maxdetoxpro,574,574,0
05:04:2014,maxgarciniaburn,http://goodpreview.info/maxgarciniaburn,455,455,0
05:04:2014,maximumshred,http://goodpreview.info/maximumshred,1517,1519,-2
05:04:2014,maxrobust,http://goodpreview.info/maxrobust,251,254,-3
05:04:2014,maxrobustxtreme,http://goodpreview.info/maxrobustxtreme,521,521,0
05:04:2014,mightyraspberryketone,http://goodpreview.info/mightyraspberryketone,5100,5105,-5
05:04:2014,miraclegarciniacambogia,http://goodpreview.info/miraclegarciniacambogia,478,481,-3
05:04:2014,miraclegreencoffee,http://goodpreview.info/miraclegreencoffee,500,515,-15
05:04:2014,miraclesaffron,http://goodpreview.info/miraclesaffron,47,48,-1
05:04:2014,mitoslim,http://goodpreview.info/mitoslim,2053,2055,-2
05:04:2014,musclefactorx,http://goodpreview.info/musclefactorx,1430,1439,-9
05:04:2014,musclefactorx-1,http://goodpreview.info/musclefactorx-1,20,22,-2
05:04:2014,musclekingpro,http://goodpreview.info/musclekingpro,499,501,-2
05:04:2014,musclemaxextreme,http://goodpreview.info/musclemaxextreme,137,137,0
05:04:2014,muscleplus,http://goodpreview.info/muscleplus,140,141,-1
05:04:2014,musclerevolutionpro,http://goodpreview.info/musclerevolutionpro,1398,1403,-5
05:04:2014,musclerevx,http://goodpreview.info/musclerevx,82,89,-7
05:04:2014,musclerevxtreme,http://goodpreview.info/musclerevxtreme,57,58,-1
05:04:2014,musclexlerator,http://goodpreview.info/musclexlerator,24,24,0
05:04:2014,musclexmax,http://goodpreview.info/musclexmax,1423,1426,-3
05:04:2014,musclexmax1,http://goodpreview.info/musclexmax1,277,278,-1
05:04:2014,musclezx90,http://goodpreview.info/musclezx90,4955,4969,-14
05:04:2014,naturalcleanse,http://goodpreview.info/naturalcleanse,7987,8003,-16
05:04:2014,naturalgarciniacambogia,http://goodpreview.info/naturalgarciniacambogia,2753,2764,-11
05:04:2014,naturalgreencoffee,http://goodpreview.info/naturalgreencoffee,7,8,-1
05:04:2014,naturalhealthgarcinia,http://goodpreview.info/naturalhealthgarcinia,48,50,-2
05:04:2014,naturalpurecleanse,http://goodpreview.info/naturalpurecleanse,1536,1548,-12
05:04:2014,nauseam,http://goodpreview.info/nauseam,133,135,-2
05:04:2014,nauseamplus,http://goodpreview.info/nauseamplus,0,0,0
05:04:2014,nextrim,http://goodpreview.info/nextrim,1722,1724,-2
05:04:2014,nitricmusclemax,http://goodpreview.info/nitricmusclemax,13425,13637,-212
05:04:2014,nitrofocusno3,http://goodpreview.info/nitrofocusno3,71,83,-12
05:04:2014,niwali,http://goodpreview.info/niwali,805,807,-2
05:04:2014,no2explodeextreme,http://goodpreview.info/no2explodeextreme,161,161,0
05:04:2014,no2extremerush,http://goodpreview.info/no2extremerush,1297,1300,-3
05:04:2014,noflameecigs,http://goodpreview.info/noflameecigs,350,350,0
05:04:2014,nuclearno,http://goodpreview.info/nuclearno,367,367,0
05:04:2014,nuetrim,http://goodpreview.info/nuetrim,659,659,0
05:04:2014,nutragreencoffee,http://goodpreview.info/nutragreencoffee,3541,3557,-16
05:04:2014,nutrapuregarcinia,http://goodpreview.info/nutrapuregarcinia,208,209,-1
05:04:2014,nutratoneplus,http://goodpreview.info/nutratoneplus,999,1001,-2
05:04:2014,nutriberryslim,http://goodpreview.info/nutriberryslim,1097,1120,-23
05:04:2014,nuvoryn,http://goodpreview.info/nuvoryn,22,22,0
05:04:2014,optimalstack,http://goodpreview.info/optimalstack,1645,1651,-6
05:04:2014,optimummuscle,http://goodpreview.info/optimummuscle,203,205,-2
05:04:2014,organicgreencoffee,http://goodpreview.info/organicgreencoffee,90,90,0
05:04:2014,organicwhitekidneybean,http://goodpreview.info/organicwhitekidneybean,90,91,-1
05:04:2014,orviax,http://goodpreview.info/orviax,88,89,-1
05:04:2014,oxitamin,http://goodpreview.info/oxitamin,146,147,-1
05:04:2014,phtytoceramides,http://goodpreview.info/phtytoceramides,799,807,-8
05:04:2014,powerigf,http://goodpreview.info/powerigf,1780,1795,-15
05:04:2014,powerpumpxl,http://goodpreview.info/powerpumpxl,367,367,0
05:04:2014,powerup,http://goodpreview.info/powerup,117,118,-1
05:04:2014,premiermangocleanse,http://goodpreview.info/premiermangocleanse,512,513,-1
05:04:2014,premiumcleanse,http://goodpreview.info/premiumcleanse,2737,2748,-11
05:04:2014,premiumgarciniacambogia,http://goodpreview.info/premiumgarciniacambogia,400,400,0
05:04:2014,premiumgarciniaextract,http://goodpreview.info/premiumgarciniaextract,704,710,-6
05:04:2014,premiumgreencoffee,http://goodpreview.info/premiumgreencoffee,119,119,0
05:04:2014,premiumgreencoffee800,http://goodpreview.info/premiumgreencoffee800,108,108,0
05:04:2014,premiumraspberryketone,http://goodpreview.info/premiumraspberryketone,43,43,0
05:04:2014,primalitegarciniaextract,http://goodpreview.info/primalitegarciniaextract,715,722,-7
05:04:2014,progain350,http://goodpreview.info/progain350,216,226,-10
05:04:2014,prograce,http://goodpreview.info/prograce,3,3,0
05:04:2014,promusclecomplex,http://goodpreview.info/promusclecomplex,49,49,0
05:04:2014,propowercleanse,http://goodpreview.info/propowercleanse,1019,1044,-25
05:04:2014,pureberrymax,http://goodpreview.info/pureberrymax,214,215,-1
05:04:2014,purecleansehealth,http://goodpreview.info/purecleansehealth,107,107,0
05:04:2014,purecollagen,http://goodpreview.info/purecollagen,2221,2223,-2
05:04:2014,puregarciniacambogia,http://goodpreview.info/puregarciniacambogia,1208,1209,-1
05:04:2014,puregarciniaslim,http://goodpreview.info/puregarciniaslim,155,165,-10
05:04:2014,puregreencoffeebeanextract,http://goodpreview.info/puregreencoffeebeanextract,2707,2712,-5
05:04:2014,puregreencoffeemaxima,http://goodpreview.info/puregreencoffeemaxima,37,37,0
05:04:2014,puregriffonia,http://goodpreview.info/puregriffonia,96,96,0
05:04:2014,pureketoneslim,http://goodpreview.info/pureketoneslim,31,32,-1
05:04:2014,purelifeclanse,http://goodpreview.info/purelifeclanse,6,6,0
05:04:2014,puremusclepro,http://goodpreview.info/puremusclepro,1801,1802,-1
05:04:2014,purenaturalcleanser,http://goodpreview.info/purenaturalcleanser,477,477,0
05:04:2014,purephytoceramides,http://goodpreview.info/purephytoceramides,74,74,0
05:04:2014,pureraspberryketonepremium,http://goodpreview.info/pureraspberryketonepremium,62,63,-1
05:04:2014,puresaffronslim,http://goodpreview.info/puresaffronslim,423,423,0
05:04:2014,pureslim57,http://goodpreview.info/pureslim57,126,126,0
05:04:2014,purgarciniacambogia,http://goodpreview.info/purgarciniacambogia,157,157,0
05:04:2014,purgreencoffee,http://goodpreview.info/purgreencoffee,1626,1626,0
05:04:2014,purifyre,http://goodpreview.info/purifyre,244,244,0
05:04:2014,purifyregreencoffee,http://goodpreview.info/purifyregreencoffee,0,0,0
05:04:2014,raspberryhealth,http://goodpreview.info/raspberryhealth,60,61,-1
05:04:2014,raspberryketoneblast,http://goodpreview.info/raspberryketoneblast,4147,4194,-47
05:04:2014,raspberryketoned,http://goodpreview.info/raspberryketoned,2,2,0
05:04:2014,raspberryketoneoptimum,http://goodpreview.info/raspberryketoneoptimum,5,5,0
05:04:2014,raspberryketonepremium,http://goodpreview.info/raspberryketonepremium,78,79,-1
05:04:2014,raspberryketonepure,http://goodpreview.info/raspberryketonepure,2,2,0
05:04:2014,raspberryketonethin,http://goodpreview.info/raspberryketonethin,9,18,-9
05:04:2014,raspberryslimplus,http://goodpreview.info/raspberryslimplus,125,127,-2
05:04:2014,refuelextreme,http://goodpreview.info/refuelextreme,480,488,-8
05:04:2014,regalecig,http://goodpreview.info/regalecig,369,372,-3
05:04:2014,regalecigs,http://goodpreview.info/regalecigs,40,41,-1
05:04:2014,rejuvaglow,http://goodpreview.info/rejuvaglow,71,71,0
05:04:2014,rejuveneyemax,http://goodpreview.info/rejuveneyemax,41,55,-14
05:04:2014,rellift,http://goodpreview.info/rellift,29,29,0
05:04:2014,renovo,http://goodpreview.info/renovo,37,37,0
05:04:2014,restiflex,http://goodpreview.info/restiflex,62,63,-1
05:04:2014,revitalize,http://goodpreview.info/revitalize,25,25,0
05:04:2014,revitatone,http://goodpreview.info/revitatone,8865,8907,-42
05:04:2014,revolutionaryraspberryketone,http://goodpreview.info/revolutionaryraspberryketone,65,65,0
05:04:2014,revoreplex,http://goodpreview.info/revoreplex,6,9,-3
05:04:2014,revtesttestosterone,http://goodpreview.info/revtesttestosterone,1591,1593,-2
05:04:2014,rippedmusclex,http://goodpreview.info/rippedmusclex,171,187,-16
05:04:2014,rippedxburn,http://goodpreview.info/rippedxburn,185,185,0
05:04:2014,sacredarganoil,http://goodpreview.info/sacredarganoil,48,48,0
05:04:2014,safercolon,http://goodpreview.info/safercolon,3049,3090,-41
05:04:2014,saffronextractpremium,http://goodpreview.info/saffronextractpremium,105,105,0
05:04:2014,saffronextractselect,http://goodpreview.info/saffronextractselect,1359,1365,-6
05:04:2014,saffronselect,http://goodpreview.info/saffronselect,72,72,0
05:04:2014,secretgreencoffee,http://goodpreview.info/secretgreencoffee,259,262,-3
05:04:2014,simpleantiaging,http://goodpreview.info/simpleantiaging,230,230,0
05:04:2014,simplygarcinia,http://goodpreview.info/simplygarcinia,1085,1102,-17
05:04:2014,skinlift,http://goodpreview.info/skinlift,2146,2147,-1
05:04:2014,slendera,http://goodpreview.info/slendera,15,15,0
05:04:2014,slenderagc-1,http://goodpreview.info/slenderagc-1,396,401,-5
05:04:2014,slimatrex,http://goodpreview.info/slimatrex,616,617,-1
05:04:2014,slimhelper,http://goodpreview.info/slimhelper,245,246,-1
05:04:2014,slimher,http://goodpreview.info/slimher,171,171,0
05:04:2014,slimmeryougarcinia,http://goodpreview.info/slimmeryougarcinia,0,0,0
05:04:2014,slimtropical,http://goodpreview.info/slimtropical,806,807,-1
05:04:2014,slimtropicalmx,http://goodpreview.info/slimtropicalmx,134,135,-1
05:04:2014,slimzenu,http://goodpreview.info/slimzenu,201,201,0
05:04:2014,smokestarecig,http://goodpreview.info/smokestarecig,548,549,-1
05:04:2014,solpriaxtreme,http://goodpreview.info/solpriaxtreme,2780,2783,-3
05:04:2014,sorepressin,http://goodpreview.info/sorepressin,6,6,0
05:04:2014,speedtrimxs,http://goodpreview.info/speedtrimxs,95,95,0
05:04:2014,splendyr,http://goodpreview.info/splendyr,1273,1274,-1
05:04:2014,splendyrantiaging,http://goodpreview.info/splendyrantiaging,51,51,0
05:04:2014,superacaicleanse,http://goodpreview.info/superacaicleanse,21,21,0
05:04:2014,supercleansetotal,http://goodpreview.info/supercleansetotal,67,69,-2
05:04:2014,supergreencoffee,http://goodpreview.info/supergreencoffee,11,11,0
05:04:2014,supergreencoffeebean,http://goodpreview.info/supergreencoffeebean,20,20,0
05:04:2014,superiormusclex,http://goodpreview.info/superiormusclex,94,5,89
05:04:2014,superiorvelvet,http://goodpreview.info/superiorvelvet,1,1,0
05:04:2014,superyacon1000,http://goodpreview.info/superyacon1000,20,20,0
05:04:2014,supracleanse350,http://goodpreview.info/supracleanse350,0,0,0
05:04:2014,supragreencoffee,http://goodpreview.info/supragreencoffee,910,916,-6
05:04:2014,supragreencoffeebean,http://goodpreview.info/supragreencoffeebean,0,0,0
05:04:2014,surelyyoung,http://goodpreview.info/surelyyoung,29,29,0
05:04:2014,swissrose,http://goodpreview.info/swissrose,340,341,-1
05:04:2014,swolekreate,http://goodpreview.info/swolekreate,192,192,0
05:04:2014,syneocell,http://goodpreview.info/syneocell,55,56,-1
05:04:2014,t-force,http://goodpreview.info/t-force,190,193,-3
05:04:2014,testforcextreme,http://goodpreview.info/testforcextreme,491,491,0
05:04:2014,testoforce,http://goodpreview.info/testoforce,14,21,-7
05:04:2014,testorushrx,http://goodpreview.info/testorushrx,40,40,0
05:04:2014,testosteronemax,http://goodpreview.info/testosteronemax,328,329,-1
05:04:2014,testoxl,http://goodpreview.info/testoxl,1470,1478,-8
05:04:2014,thinmagic,http://goodpreview.info/thinmagic,272,272,0
05:04:2014,thinmagicmax,http://goodpreview.info/thinmagicmax,0,0,0
05:04:2014,thinsport,http://goodpreview.info/thinsport,211,211,0
05:04:2014,titaniumprox,http://goodpreview.info/titaniumprox,0,0,0
05:04:2014,totalbodyfresh,http://goodpreview.info/totalbodyfresh,114,115,-1
05:04:2014,trigx2,http://goodpreview.info/trigx2,9,11,-2
05:04:2014,trimaleana,http://goodpreview.info/trimaleana,142,142,0
05:04:2014,trimatol,http://goodpreview.info/trimatol,121,123,-2
05:04:2014,trimblendgarciniacambogia,http://goodpreview.info/trimblendgarciniacambogia,72,75,-3
05:04:2014,triminexgarciniacambogia,http://goodpreview.info/triminexgarciniacambogia,87,89,-2
05:04:2014,triminexgreencoffee,http://goodpreview.info/triminexgreencoffee,53,55,-2
05:04:2014,tripleeffectseyeserum,http://goodpreview.info/tripleeffectseyeserum,603,608,-5
05:04:2014,turboextracut,http://goodpreview.info/turboextracut,160,161,-1
05:04:2014,turboshred,http://goodpreview.info/turboshred,100,100,0
05:04:2014,ultimategarcinia,http://goodpreview.info/ultimategarcinia,164,164,0
05:04:2014,ultramaxtestosterone,http://goodpreview.info/ultramaxtestosterone,33,33,0
05:04:2014,ultrapurecoloncleanse,http://goodpreview.info/ultrapurecoloncleanse,4,4,0
05:04:2014,ultraraspberryketone,http://goodpreview.info/ultraraspberryketone,418,418,0
05:04:2014,velora,http://goodpreview.info/velora,23,23,0
05:04:2014,velveskin,http://goodpreview.info/velveskin,17,17,0
05:04:2014,vencleanse,http://goodpreview.info/vencleanse,431,431,0
05:04:2014,viarex,http://goodpreview.info/viarex,599,600,-1
05:04:2014,vitalifedetox,http://goodpreview.info/vitalifedetox,255,257,-2
05:04:2014,vitalitygreencoffee,http://goodpreview.info/vitalitygreencoffee,85,85,0
05:04:2014,vitamax,http://goodpreview.info/vitamax,22,22,0
05:04:2014,vitolipo,http://goodpreview.info/vitolipo,1135,1141,-6
05:04:2014,vydox,http://goodpreview.info/vydox,307,310,-3
05:04:2014,wildraspberryketone,http://goodpreview.info/wildraspberryketone,174,178,-4
05:04:2014,wrinklesscream,http://goodpreview.info/wrinklesscream,273,282,-9
05:04:2014,xenaslim,http://goodpreview.info/xenaslim,41,41,0
05:04:2014,xengthx1,http://goodpreview.info/xengthx1,32,32,0
05:04:2014,xlerator,http://goodpreview.info/xlerator,0,0,0
05:04:2014,xocigs,http://goodpreview.info/xocigs,65,65,0
05:04:2014,xtgenix,http://goodpreview.info/xtgenix,12953,12958,-5
05:04:2014,xtrememusclepro,http://goodpreview.info/xtrememusclepro,608,610,-2
05:04:2014,yaconsplash,http://goodpreview.info/yaconsplash,21,21,0
05:04:2014,yaconsyruporiginal,http://goodpreview.info/yaconsyruporiginal,94,95,-1
05:04:2014,yaconsyrupsecret,http://goodpreview.info/yaconsyrupsecret,32,34,-2
05:04:2014,yoloboost,http://goodpreview.info/yoloboost,2,3,-1
05:04:2014,youthkiteyecream,http://goodpreview.info/youthkiteyecream,244,244,0
