dt_today,sitetitle,sitelink,pre_click,new_clicks,difrnce
09:04:2014,11fruits,http://goodpreview.info/11fruits,200,206,-6
09:04:2014,1285muscle,http://goodpreview.info/1285muscle,2872,2873,-1
09:04:2014,92trimgreencoffee,http://goodpreview.info/92trimgreencoffee,37,37,0
09:04:2014,Americig,http://goodpreview.info/Americig,463,466,-3
09:04:2014,Nuvagenic,http://goodpreview.info/Nuvagenic,1104,1105,-1
09:04:2014,Prolexin,http://goodpreview.info/Prolexin,891,928,-37
09:04:2014,SVELME,http://goodpreview.info/SVELME,800,800,0
09:04:2014,SlimSpray,http://goodpreview.info/SlimSpray,288,294,-6
09:04:2014,acaiberryfresh,http://goodpreview.info/acaiberryfresh,98,98,0
09:04:2014,acainatural,http://goodpreview.info/acainatural,133,133,0
09:04:2014,acaiultralean,http://goodpreview.info/acaiultralean,132,132,0
09:04:2014,advancedgarciniacambogia,http://goodpreview.info/advancedgarciniacambogia,884,885,-1
09:04:2014,advancedgarciniacambogia-fr,http://goodpreview.info/advancedgarciniacambogia-fr,137,144,-7
09:04:2014,advancedgarciniacambogia1,http://goodpreview.info/advancedgarciniacambogia1,34,36,-2
09:04:2014,advancedkrealkalyn,http://goodpreview.info/advancedkrealkalyn,147,147,0
09:04:2014,advancedpurecleanse,http://goodpreview.info/advancedpurecleanse,0,0,0
09:04:2014,advancedpurecleanse1,http://goodpreview.info/advancedpurecleanse1,37,43,-6
09:04:2014,africanmangoboost,http://goodpreview.info/africanmangoboost,118,118,0
09:04:2014,africanmangoprox,http://goodpreview.info/africanmangoprox,43,44,-1
09:04:2014,africanmangopure,http://goodpreview.info/africanmangopure,77,77,0
09:04:2014,aktiveam,http://goodpreview.info/aktiveam,1609,1609,0
09:04:2014,aktivepm,http://goodpreview.info/aktivepm,2033,2037,-4
09:04:2014,alphajacked,http://goodpreview.info/alphajacked,773,773,0
09:04:2014,alphamaxplus,http://goodpreview.info/alphamaxplus,18,18,0
09:04:2014,amazing,http://goodpreview.info/amazing,371,383,-12
09:04:2014,aminomuscle,http://goodpreview.info/aminomuscle,1208,1210,-2
09:04:2014,aminoprime,http://goodpreview.info/aminoprime,113,113,0
09:04:2014,aminoprimexl,http://goodpreview.info/aminoprimexl,290,294,-4
09:04:2014,anabolicrx24,http://goodpreview.info/anabolicrx24,18674,18918,-244
09:04:2014,anatomyx5,http://goodpreview.info/anatomyx5,3,3,0
09:04:2014,androsolve,http://goodpreview.info/androsolve,1478,1483,-5
09:04:2014,androx,http://goodpreview.info/androx,13881,13967,-86
09:04:2014,anoradrol,http://goodpreview.info/anoradrol,218,218,0
09:04:2014,auravie,http://goodpreview.info/auravie,105,106,-1
09:04:2014,authenticgreencoffee,http://goodpreview.info/authenticgreencoffee,240,240,0
09:04:2014,beaudify,http://goodpreview.info/beaudify,75,75,0
09:04:2014,beautefxbbcream,http://goodpreview.info/beautefxbbcream,3,3,0
09:04:2014,beautynectarcollagen,http://goodpreview.info/beautynectarcollagen,134,134,0
09:04:2014,beddefense,http://goodpreview.info/beddefense,28,28,0
09:04:2014,bellagenix,http://goodpreview.info/bellagenix,138,138,0
09:04:2014,bellalabs,http://goodpreview.info/bellalabs,8,8,0
09:04:2014,bellaplex,http://goodpreview.info/bellaplex,7,7,0
09:04:2014,beriultimatepro,http://goodpreview.info/beriultimatepro,69,69,0
09:04:2014,berrythin,http://goodpreview.info/berrythin,332,332,0
09:04:2014,betaalaninemax,http://goodpreview.info/betaalaninemax,0,0,0
09:04:2014,betaalaninextreme,http://goodpreview.info/betaalaninextreme,18,19,-1
09:04:2014,beyondraspberry,http://goodpreview.info/beyondraspberry,77,77,0
09:04:2014,biohealthgarciniacambogia,http://goodpreview.info/biohealthgarciniacambogia,3682,3708,-26
09:04:2014,biomelt,http://goodpreview.info/biomelt,361,361,0
09:04:2014,blastxl,http://goodpreview.info/blastxl,170,172,-2
09:04:2014,bodycleanseplus,http://goodpreview.info/bodycleanseplus,66,66,0
09:04:2014,bodywrap,http://goodpreview.info/bodywrap,209,209,0
09:04:2014,breakfree,http://goodpreview.info/breakfree,113,113,0
09:04:2014,cambogiatrim,http://goodpreview.info/cambogiatrim,598,599,-1
09:04:2014,capsicum,http://goodpreview.info/capsicum,140,140,0
09:04:2014,celebritycleanser,http://goodpreview.info/celebritycleanser,168,235,-67
09:04:2014,celebrityraspberry,http://goodpreview.info/celebrityraspberry,145,145,0
09:04:2014,cellanafricanmango,http://goodpreview.info/cellanafricanmango,265,268,-3
09:04:2014,cellogicaskin,http://goodpreview.info/cellogicaskin,51,52,-1
09:04:2014,centrislim,http://goodpreview.info/centrislim,199,199,0
09:04:2014,certifiedgreencoffee,http://goodpreview.info/certifiedgreencoffee,149,149,0
09:04:2014,certifiedpuregreencoffee,http://goodpreview.info/certifiedpuregreencoffee,19,19,0
09:04:2014,chiocegreencoffee,http://goodpreview.info/chiocegreencoffee,545,545,0
09:04:2014,choicegreencoffee,http://goodpreview.info/choicegreencoffee,385,395,-10
09:04:2014,cleansefx,http://goodpreview.info/cleansefx,396,456,-60
09:04:2014,cleanseplus,http://goodpreview.info/cleanseplus,432,437,-5
09:04:2014,cleanseplus1,http://goodpreview.info/cleanseplus1,0,0,0
09:04:2014,cleansepremium,http://goodpreview.info/cleansepremium,15,15,0
09:04:2014,cleansewonder,http://goodpreview.info/cleansewonder,206,1,205
09:04:2014,cleansextrem,http://goodpreview.info/cleansextrem,293,334,-41
09:04:2014,cleantrim,http://goodpreview.info/cleantrim,229,229,0
09:04:2014,clearcleansepro,http://goodpreview.info/clearcleansepro,112,112,0
09:04:2014,clearsmoke,http://goodpreview.info/clearsmoke,177,177,0
09:04:2014,codered7,http://goodpreview.info/codered7,314,320,-6
09:04:2014,coleanse,http://goodpreview.info/coleanse,124,125,-1
09:04:2014,collaton,http://goodpreview.info/collaton,88,88,0
09:04:2014,colocleansepro,http://goodpreview.info/colocleansepro,1,1,0
09:04:2014,coloncleansetotal,http://goodpreview.info/coloncleansetotal,21,22,-1
09:04:2014,colonpurecleanse,http://goodpreview.info/colonpurecleanse,133,133,0
09:04:2014,colothin,http://goodpreview.info/colothin,992,993,-1
09:04:2014,completecoffeecleanse,http://goodpreview.info/completecoffeecleanse,1987,1989,-2
09:04:2014,complexiderm,http://goodpreview.info/complexiderm,109,109,0
09:04:2014,corecutter,http://goodpreview.info/corecutter,41,41,0
09:04:2014,csorex,http://goodpreview.info/csorex,179,179,0
09:04:2014,dailyfacelift,http://goodpreview.info/dailyfacelift,99,99,0
09:04:2014,dailyfacestemcelltechnology,http://goodpreview.info/dailyfacestemcelltechnology,196,197,-1
09:04:2014,dailypowercleanse,http://goodpreview.info/dailypowercleanse,128,129,-1
09:04:2014,deerantlerxtreme,http://goodpreview.info/deerantlerxtreme,134,135,-1
09:04:2014,dermarose,http://goodpreview.info/dermarose,113,113,0
09:04:2014,dermaset,http://goodpreview.info/dermaset,51,51,0
09:04:2014,dermpure,http://goodpreview.info/dermpure,80,80,0
09:04:2014,dietgreencoffeebean,http://goodpreview.info/dietgreencoffeebean,312,312,0
09:04:2014,drillpill,http://goodpreview.info/drillpill,458,458,0
09:04:2014,elevategf,http://goodpreview.info/elevategf,178,178,0
09:04:2014,elier,http://goodpreview.info/elier,50,50,0
09:04:2014,elierskincare,http://goodpreview.info/elierskincare,41,41,0
09:04:2014,elitetest360,http://goodpreview.info/elitetest360,466,479,-13
09:04:2014,emeraldluxecig,http://goodpreview.info/emeraldluxecig,113,113,0
09:04:2014,enduros,http://goodpreview.info/enduros,985,988,-3
09:04:2014,envigra,http://goodpreview.info/envigra,106,106,0
09:04:2014,estrodetox,http://goodpreview.info/estrodetox,100,102,-2
09:04:2014,extentxl,http://goodpreview.info/extentxl,176,176,0
09:04:2014,fembalance,http://goodpreview.info/fembalance,17,17,0
09:04:2014,flawlessraspberryketone,http://goodpreview.info/flawlessraspberryketone,90,90,0
09:04:2014,formulat10,http://goodpreview.info/formulat10,1513,1513,0
09:04:2014,garcinaiawow1,http://goodpreview.info/garcinaiawow1,84,95,-11
09:04:2014,garciniacambogia,http://goodpreview.info/garciniacambogia,344,370,-26
09:04:2014,garciniacambogia1000,http://goodpreview.info/garciniacambogia1000,62,62,0
09:04:2014,garciniacambogiaelite,http://goodpreview.info/garciniacambogiaelite,5313,5333,-20
09:04:2014,garciniacambogiafatbuster,http://goodpreview.info/garciniacambogiafatbuster,91,91,0
09:04:2014,garciniacambogiamax,http://goodpreview.info/garciniacambogiamax,2411,2420,-9
09:04:2014,garciniacambogiamiracle,http://goodpreview.info/garciniacambogiamiracle,130,131,-1
09:04:2014,garciniacambogiapremium,http://goodpreview.info/garciniacambogiapremium,1076,1076,0
09:04:2014,garciniacambogiapureextract,http://goodpreview.info/garciniacambogiapureextract,145,146,-1
09:04:2014,garciniacambogiapureselect,http://goodpreview.info/garciniacambogiapureselect,602,608,-6
09:04:2014,garciniacambogiasupreme,http://goodpreview.info/garciniacambogiasupreme,3404,3513,-109
09:04:2014,garciniacambogiatoday,http://goodpreview.info/garciniacambogiatoday,140,142,-2
09:04:2014,garciniacambogiaultra,http://goodpreview.info/garciniacambogiaultra,366,369,-3
09:04:2014,garciniaforte,http://goodpreview.info/garciniaforte,65,76,-11
09:04:2014,garciniafreetrial,http://goodpreview.info/garciniafreetrial,69,69,0
09:04:2014,garciniagreen,http://goodpreview.info/garciniagreen,843,846,-3
09:04:2014,garciniapureelite1,http://goodpreview.info/garciniapureelite1,1,1,0
09:04:2014,garciniatoday,http://goodpreview.info/garciniatoday,0,0,0
09:04:2014,garciniatotal,http://goodpreview.info/garciniatotal,100,100,0
09:04:2014,garciniawow,http://goodpreview.info/garciniawow,999,1037,-38
09:04:2014,garcinium,http://goodpreview.info/garcinium,38,44,-6
09:04:2014,gc7x,http://goodpreview.info/gc7x,103,103,0
09:04:2014,gc7xgreencoffee,http://goodpreview.info/gc7xgreencoffee,0,0,0
09:04:2014,gcbultra,http://goodpreview.info/gcbultra,52,53,-1
09:04:2014,gcbx,http://goodpreview.info/gcbx,17094,17103,-9
09:04:2014,gcbx1,http://goodpreview.info/gcbx1,196,196,0
09:04:2014,gcspeedslim,http://goodpreview.info/gcspeedslim,5794,5824,-30
09:04:2014,gcultra,http://goodpreview.info/gcultra,137,137,0
09:04:2014,gcultragarcinia,http://goodpreview.info/gcultragarcinia,4,4,0
09:04:2014,geneme,http://goodpreview.info/geneme,40,40,0
09:04:2014,getnaturalgarcinia,http://goodpreview.info/getnaturalgarcinia,41,42,-1
09:04:2014,greencoffeeadvanced,http://goodpreview.info/greencoffeeadvanced,181,181,0
09:04:2014,greencoffeebean8000,http://goodpreview.info/greencoffeebean8000,66,66,0
09:04:2014,greencoffeebody,http://goodpreview.info/greencoffeebody,33,33,0
09:04:2014,greencoffeeburn,http://goodpreview.info/greencoffeeburn,25,25,0
09:04:2014,greencoffeeextreme,http://goodpreview.info/greencoffeeextreme,84,84,0
09:04:2014,greencoffeemax,http://goodpreview.info/greencoffeemax,137,139,-2
09:04:2014,greencoffeemaxx,http://goodpreview.info/greencoffeemaxx,5,7,-2
09:04:2014,greencoffeeoptimum,http://goodpreview.info/greencoffeeoptimum,125,125,0
09:04:2014,greencoffeeprogram,http://goodpreview.info/greencoffeeprogram,0,0,0
09:04:2014,greencoffeeultraslim,http://goodpreview.info/greencoffeeultraslim,208,208,0
09:04:2014,greentonepro,http://goodpreview.info/greentonepro,309,309,0
09:04:2014,healthetrimgarcinia,http://goodpreview.info/healthetrimgarcinia,154,154,0
09:04:2014,healthychoicegc,http://goodpreview.info/healthychoicegc,748,748,0
09:04:2014,horsepowerplusxxxl,http://goodpreview.info/horsepowerplusxxxl,257,265,-8
09:04:2014,hugegenic,http://goodpreview.info/hugegenic,350,358,-8
09:04:2014,hydrellatone,http://goodpreview.info/hydrellatone,103,104,-1
09:04:2014,hydrocollagen,http://goodpreview.info/hydrocollagen,45,46,-1
09:04:2014,hydroderm,http://goodpreview.info/hydroderm,47,47,0
09:04:2014,hyperfuel9x,http://goodpreview.info/hyperfuel9x,1948,1958,-10
09:04:2014,illuminatedteeth,http://goodpreview.info/illuminatedteeth,46,49,-3
09:04:2014,instantwrinklerepair,http://goodpreview.info/instantwrinklerepair,18,18,0
09:04:2014,iqderma,http://goodpreview.info/iqderma,419,419,0
09:04:2014,iqdermaessen,http://goodpreview.info/iqdermaessen,0,0,0
09:04:2014,ketoneoptimum,http://goodpreview.info/ketoneoptimum,155,155,0
09:04:2014,kleanslim,http://goodpreview.info/kleanslim,100,100,0
09:04:2014,lacreme,http://goodpreview.info/lacreme,7,34,-27
09:04:2014,leanmuscleformula,http://goodpreview.info/leanmuscleformula,54,55,-1
09:04:2014,ledermeluxe,http://goodpreview.info/ledermeluxe,185,185,0
09:04:2014,leparfait,http://goodpreview.info/leparfait,21,25,-4
09:04:2014,leparisehydragold,http://goodpreview.info/leparisehydragold,4,4,0
09:04:2014,levela,http://goodpreview.info/levela,106,106,0
09:04:2014,lifedetox,http://goodpreview.info/lifedetox,146,146,0
09:04:2014,liftserumpro,http://goodpreview.info/liftserumpro,189,191,-2
09:04:2014,liposlender,http://goodpreview.info/liposlender,26,29,-3
09:04:2014,liposlim,http://goodpreview.info/liposlim,1885,1902,-17
09:04:2014,liposom,http://goodpreview.info/liposom,62,62,0
09:04:2014,liveskinny,http://goodpreview.info/liveskinny,233,233,0
09:04:2014,lumahydrate,http://goodpreview.info/lumahydrate,413,420,-7
09:04:2014,lumarepair,http://goodpreview.info/lumarepair,497,504,-7
09:04:2014,lunathin,http://goodpreview.info/lunathin,127,127,0
09:04:2014,luxoderm,http://goodpreview.info/luxoderm,213,214,-1
09:04:2014,lysocleanse,http://goodpreview.info/lysocleanse,1811,1829,-18
09:04:2014,maxdetoxpro,http://goodpreview.info/maxdetoxpro,574,576,-2
09:04:2014,maxgarciniaburn,http://goodpreview.info/maxgarciniaburn,455,455,0
09:04:2014,maximumshred,http://goodpreview.info/maximumshred,1532,1541,-9
09:04:2014,maxrobust,http://goodpreview.info/maxrobust,260,262,-2
09:04:2014,maxrobustxtreme,http://goodpreview.info/maxrobustxtreme,522,522,0
09:04:2014,mightyraspberryketone,http://goodpreview.info/mightyraspberryketone,5115,5120,-5
09:04:2014,miraclegarciniacambogia,http://goodpreview.info/miraclegarciniacambogia,496,502,-6
09:04:2014,miraclegreencoffee,http://goodpreview.info/miraclegreencoffee,541,552,-11
09:04:2014,miraclesaffron,http://goodpreview.info/miraclesaffron,52,52,0
09:04:2014,mitoslim,http://goodpreview.info/mitoslim,2060,2061,-1
09:04:2014,musclefactorx,http://goodpreview.info/musclefactorx,1442,1443,-1
09:04:2014,musclefactorx-1,http://goodpreview.info/musclefactorx-1,22,22,0
09:04:2014,musclekingpro,http://goodpreview.info/musclekingpro,501,501,0
09:04:2014,musclemaxextreme,http://goodpreview.info/musclemaxextreme,137,137,0
09:04:2014,muscleplus,http://goodpreview.info/muscleplus,143,143,0
09:04:2014,musclerevolutionpro,http://goodpreview.info/musclerevolutionpro,1428,1433,-5
09:04:2014,musclerevx,http://goodpreview.info/musclerevx,97,102,-5
09:04:2014,musclerevxtreme,http://goodpreview.info/musclerevxtreme,61,65,-4
09:04:2014,musclexlerator,http://goodpreview.info/musclexlerator,28,28,0
09:04:2014,musclexmax,http://goodpreview.info/musclexmax,1449,1463,-14
09:04:2014,musclexmax1,http://goodpreview.info/musclexmax1,278,280,-2
09:04:2014,musclezx90,http://goodpreview.info/musclezx90,5000,5011,-11
09:04:2014,naturalcleanse,http://goodpreview.info/naturalcleanse,8034,8043,-9
09:04:2014,naturalgarciniacambogia,http://goodpreview.info/naturalgarciniacambogia,2769,2770,-1
09:04:2014,naturalgreencoffee,http://goodpreview.info/naturalgreencoffee,9,9,0
09:04:2014,naturalhealthgarcinia,http://goodpreview.info/naturalhealthgarcinia,53,54,-1
09:04:2014,naturalpurecleanse,http://goodpreview.info/naturalpurecleanse,10,23,-13
09:04:2014,nauseam,http://goodpreview.info/nauseam,135,135,0
09:04:2014,nauseamplus,http://goodpreview.info/nauseamplus,0,0,0
09:04:2014,nextrim,http://goodpreview.info/nextrim,1738,1742,-4
09:04:2014,nitricmusclemax,http://goodpreview.info/nitricmusclemax,14232,14426,-194
09:04:2014,nitrofocusno3,http://goodpreview.info/nitrofocusno3,94,100,-6
09:04:2014,niwali,http://goodpreview.info/niwali,825,827,-2
09:04:2014,no2explodeextreme,http://goodpreview.info/no2explodeextreme,163,163,0
09:04:2014,no2extremerush,http://goodpreview.info/no2extremerush,1307,1308,-1
09:04:2014,noflameecigs,http://goodpreview.info/noflameecigs,350,350,0
09:04:2014,nuclearno,http://goodpreview.info/nuclearno,368,368,0
09:04:2014,nuetrim,http://goodpreview.info/nuetrim,660,660,0
09:04:2014,nutragreencoffee,http://goodpreview.info/nutragreencoffee,5,9,-4
09:04:2014,nutrapuregarcinia,http://goodpreview.info/nutrapuregarcinia,211,214,-3
09:04:2014,nutratoneplus,http://goodpreview.info/nutratoneplus,1004,1004,0
09:04:2014,nutriberryslim,http://goodpreview.info/nutriberryslim,1199,1235,-36
09:04:2014,nuvoryn,http://goodpreview.info/nuvoryn,22,22,0
09:04:2014,optimalstack,http://goodpreview.info/optimalstack,1662,1678,-16
09:04:2014,optimummuscle,http://goodpreview.info/optimummuscle,208,209,-1
09:04:2014,organicgreencoffee,http://goodpreview.info/organicgreencoffee,91,91,0
09:04:2014,organicwhitekidneybean,http://goodpreview.info/organicwhitekidneybean,91,91,0
09:04:2014,orviax,http://goodpreview.info/orviax,89,89,0
09:04:2014,oxitamin,http://goodpreview.info/oxitamin,149,149,0
09:04:2014,phtytoceramides,http://goodpreview.info/phtytoceramides,819,824,-5
09:04:2014,powerigf,http://goodpreview.info/powerigf,1860,1888,-28
09:04:2014,powerpumpxl,http://goodpreview.info/powerpumpxl,370,370,0
09:04:2014,powerup,http://goodpreview.info/powerup,119,119,0
09:04:2014,premiermangocleanse,http://goodpreview.info/premiermangocleanse,516,519,-3
09:04:2014,premiumcleanse,http://goodpreview.info/premiumcleanse,2787,2799,-12
09:04:2014,premiumgarciniacambogia,http://goodpreview.info/premiumgarciniacambogia,404,404,0
09:04:2014,premiumgarciniaextract,http://goodpreview.info/premiumgarciniaextract,715,715,0
09:04:2014,premiumgreencoffee,http://goodpreview.info/premiumgreencoffee,119,119,0
09:04:2014,premiumgreencoffee800,http://goodpreview.info/premiumgreencoffee800,108,108,0
09:04:2014,premiumraspberryketone,http://goodpreview.info/premiumraspberryketone,44,44,0
09:04:2014,primalitegarciniaextract,http://goodpreview.info/primalitegarciniaextract,753,773,-20
09:04:2014,progain350,http://goodpreview.info/progain350,247,261,-14
09:04:2014,prograce,http://goodpreview.info/prograce,4,5,-1
09:04:2014,promusclecomplex,http://goodpreview.info/promusclecomplex,49,49,0
09:04:2014,propowercleanse,http://goodpreview.info/propowercleanse,1196,1229,-33
09:04:2014,pureberrymax,http://goodpreview.info/pureberrymax,215,215,0
09:04:2014,purecleansehealth,http://goodpreview.info/purecleansehealth,111,111,0
09:04:2014,purecollagen,http://goodpreview.info/purecollagen,2225,2226,-1
09:04:2014,puregarciniacambogia,http://goodpreview.info/puregarciniacambogia,1215,1218,-3
09:04:2014,puregarciniaslim,http://goodpreview.info/puregarciniaslim,171,172,-1
09:04:2014,puregreencoffeebeanextract,http://goodpreview.info/puregreencoffeebeanextract,2725,2732,-7
09:04:2014,puregreencoffeemaxima,http://goodpreview.info/puregreencoffeemaxima,37,37,0
09:04:2014,puregriffonia,http://goodpreview.info/puregriffonia,96,96,0
09:04:2014,pureketoneslim,http://goodpreview.info/pureketoneslim,33,33,0
09:04:2014,purelifeclanse,http://goodpreview.info/purelifeclanse,14,15,-1
09:04:2014,puremusclepro,http://goodpreview.info/puremusclepro,1810,1810,0
09:04:2014,purenaturalcleanser,http://goodpreview.info/purenaturalcleanser,480,480,0
09:04:2014,purephytoceramides,http://goodpreview.info/purephytoceramides,76,77,-1
09:04:2014,pureraspberryketonepremium,http://goodpreview.info/pureraspberryketonepremium,64,64,0
09:04:2014,puresaffronslim,http://goodpreview.info/puresaffronslim,424,424,0
09:04:2014,pureslim57,http://goodpreview.info/pureslim57,128,129,-1
09:04:2014,purgarciniacambogia,http://goodpreview.info/purgarciniacambogia,157,157,0
09:04:2014,purgreencoffee,http://goodpreview.info/purgreencoffee,1626,1626,0
09:04:2014,purifyre,http://goodpreview.info/purifyre,244,244,0
09:04:2014,purifyregreencoffee,http://goodpreview.info/purifyregreencoffee,0,0,0
09:04:2014,raspberryhealth,http://goodpreview.info/raspberryhealth,66,67,-1
09:04:2014,raspberryketoneblast,http://goodpreview.info/raspberryketoneblast,4380,4470,-90
09:04:2014,raspberryketoned,http://goodpreview.info/raspberryketoned,7,7,0
09:04:2014,raspberryketoneoptimum,http://goodpreview.info/raspberryketoneoptimum,5,5,0
09:04:2014,raspberryketonepremium,http://goodpreview.info/raspberryketonepremium,79,79,0
09:04:2014,raspberryketonepure,http://goodpreview.info/raspberryketonepure,2,2,0
09:04:2014,raspberryketonethin,http://goodpreview.info/raspberryketonethin,55,60,-5
09:04:2014,raspberryslimplus,http://goodpreview.info/raspberryslimplus,130,131,-1
09:04:2014,refuelextreme,http://goodpreview.info/refuelextreme,504,515,-11
09:04:2014,regalecig,http://goodpreview.info/regalecig,377,380,-3
09:04:2014,regalecigs,http://goodpreview.info/regalecigs,43,44,-1
09:04:2014,rejuvaglow,http://goodpreview.info/rejuvaglow,71,71,0
09:04:2014,rejuveneyemax,http://goodpreview.info/rejuveneyemax,93,104,-11
09:04:2014,rellift,http://goodpreview.info/rellift,29,30,-1
09:04:2014,renovo,http://goodpreview.info/renovo,40,40,0
09:04:2014,restiflex,http://goodpreview.info/restiflex,64,64,0
09:04:2014,revitalize,http://goodpreview.info/revitalize,26,26,0
09:04:2014,revitatone,http://goodpreview.info/revitatone,9030,9084,-54
09:04:2014,revolutionaryraspberryketone,http://goodpreview.info/revolutionaryraspberryketone,65,65,0
09:04:2014,revoreplex,http://goodpreview.info/revoreplex,12,15,-3
09:04:2014,revtesttestosterone,http://goodpreview.info/revtesttestosterone,1594,1594,0
09:04:2014,rippedmusclex,http://goodpreview.info/rippedmusclex,205,208,-3
09:04:2014,rippedxburn,http://goodpreview.info/rippedxburn,193,193,0
09:04:2014,sacredarganoil,http://goodpreview.info/sacredarganoil,49,49,0
09:04:2014,safercolon,http://goodpreview.info/safercolon,3309,3360,-51
09:04:2014,saffronextractpremium,http://goodpreview.info/saffronextractpremium,106,108,-2
09:04:2014,saffronextractselect,http://goodpreview.info/saffronextractselect,1374,1378,-4
09:04:2014,saffronselect,http://goodpreview.info/saffronselect,75,76,-1
09:04:2014,secretgreencoffee,http://goodpreview.info/secretgreencoffee,267,270,-3
09:04:2014,simpleantiaging,http://goodpreview.info/simpleantiaging,231,231,0
09:04:2014,simplygarcinia,http://goodpreview.info/simplygarcinia,1156,1192,-36
09:04:2014,skinlift,http://goodpreview.info/skinlift,2149,2151,-2
09:04:2014,slendera,http://goodpreview.info/slendera,15,15,0
09:04:2014,slenderagc-1,http://goodpreview.info/slenderagc-1,418,422,-4
09:04:2014,slimatrex,http://goodpreview.info/slimatrex,618,621,-3
09:04:2014,slimhelper,http://goodpreview.info/slimhelper,247,247,0
09:04:2014,slimher,http://goodpreview.info/slimher,172,172,0
09:04:2014,slimmeryougarcinia,http://goodpreview.info/slimmeryougarcinia,0,0,0
09:04:2014,slimtropical,http://goodpreview.info/slimtropical,811,811,0
09:04:2014,slimtropicalmx,http://goodpreview.info/slimtropicalmx,135,135,0
09:04:2014,slimzenu,http://goodpreview.info/slimzenu,201,201,0
09:04:2014,smokestarecig,http://goodpreview.info/smokestarecig,559,560,-1
09:04:2014,solpriaxtreme,http://goodpreview.info/solpriaxtreme,2794,2797,-3
09:04:2014,sorepressin,http://goodpreview.info/sorepressin,6,6,0
09:04:2014,speedtrimxs,http://goodpreview.info/speedtrimxs,95,95,0
09:04:2014,splendyr,http://goodpreview.info/splendyr,1276,1276,0
09:04:2014,splendyrantiaging,http://goodpreview.info/splendyrantiaging,52,52,0
09:04:2014,superacaicleanse,http://goodpreview.info/superacaicleanse,22,22,0
09:04:2014,supercleansetotal,http://goodpreview.info/supercleansetotal,79,87,-8
09:04:2014,supergreencoffee,http://goodpreview.info/supergreencoffee,11,11,0
09:04:2014,supergreencoffeebean,http://goodpreview.info/supergreencoffeebean,20,20,0
09:04:2014,superiormusclex,http://goodpreview.info/superiormusclex,26,37,-11
09:04:2014,superiorvelvet,http://goodpreview.info/superiorvelvet,1,1,0
09:04:2014,superyacon1000,http://goodpreview.info/superyacon1000,25,25,0
09:04:2014,supracleanse350,http://goodpreview.info/supracleanse350,0,0,0
09:04:2014,supragreencoffee,http://goodpreview.info/supragreencoffee,934,939,-5
09:04:2014,supragreencoffeebean,http://goodpreview.info/supragreencoffeebean,0,0,0
09:04:2014,surelyyoung,http://goodpreview.info/surelyyoung,30,32,-2
09:04:2014,swissrose,http://goodpreview.info/swissrose,343,344,-1
09:04:2014,swolekreate,http://goodpreview.info/swolekreate,194,194,0
09:04:2014,syneocell,http://goodpreview.info/syneocell,58,59,-1
09:04:2014,t-force,http://goodpreview.info/t-force,204,207,-3
09:04:2014,testforcextreme,http://goodpreview.info/testforcextreme,492,492,0
09:04:2014,testoforce,http://goodpreview.info/testoforce,22,24,-2
09:04:2014,testorushrx,http://goodpreview.info/testorushrx,41,43,-2
09:04:2014,testosteronemax,http://goodpreview.info/testosteronemax,331,333,-2
09:04:2014,testoxl,http://goodpreview.info/testoxl,1483,1484,-1
09:04:2014,thinmagic,http://goodpreview.info/thinmagic,275,277,-2
09:04:2014,thinmagicmax,http://goodpreview.info/thinmagicmax,0,0,0
09:04:2014,thinsport,http://goodpreview.info/thinsport,212,212,0
09:04:2014,titaniumprox,http://goodpreview.info/titaniumprox,0,0,0
09:04:2014,totalbodyfresh,http://goodpreview.info/totalbodyfresh,127,132,-5
09:04:2014,trigx2,http://goodpreview.info/trigx2,15,15,0
09:04:2014,trimaleana,http://goodpreview.info/trimaleana,142,142,0
09:04:2014,trimatol,http://goodpreview.info/trimatol,124,125,-1
09:04:2014,trimblendgarciniacambogia,http://goodpreview.info/trimblendgarciniacambogia,76,76,0
09:04:2014,triminexgarciniacambogia,http://goodpreview.info/triminexgarciniacambogia,92,94,-2
09:04:2014,triminexgreencoffee,http://goodpreview.info/triminexgreencoffee,58,59,-1
09:04:2014,tripleeffectseyeserum,http://goodpreview.info/tripleeffectseyeserum,619,619,0
09:04:2014,turboextracut,http://goodpreview.info/turboextracut,162,162,0
09:04:2014,turboshred,http://goodpreview.info/turboshred,100,100,0
09:04:2014,ultimategarcinia,http://goodpreview.info/ultimategarcinia,165,165,0
09:04:2014,ultramaxtestosterone,http://goodpreview.info/ultramaxtestosterone,33,33,0
09:04:2014,ultrapurecoloncleanse,http://goodpreview.info/ultrapurecoloncleanse,5,7,-2
09:04:2014,ultraraspberryketone,http://goodpreview.info/ultraraspberryketone,419,419,0
09:04:2014,velora,http://goodpreview.info/velora,23,23,0
09:04:2014,velveskin,http://goodpreview.info/velveskin,19,20,-1
09:04:2014,vencleanse,http://goodpreview.info/vencleanse,432,432,0
09:04:2014,viarex,http://goodpreview.info/viarex,610,616,-6
09:04:2014,vitalifedetox,http://goodpreview.info/vitalifedetox,257,257,0
09:04:2014,vitalitygreencoffee,http://goodpreview.info/vitalitygreencoffee,85,85,0
09:04:2014,vitamax,http://goodpreview.info/vitamax,22,22,0
09:04:2014,vitolipo,http://goodpreview.info/vitolipo,1150,1166,-16
09:04:2014,vydox,http://goodpreview.info/vydox,323,324,-1
09:04:2014,wildraspberryketone,http://goodpreview.info/wildraspberryketone,198,201,-3
09:04:2014,wrinklesscream,http://goodpreview.info/wrinklesscream,300,305,-5
09:04:2014,xenaslim,http://goodpreview.info/xenaslim,42,42,0
09:04:2014,xengthx1,http://goodpreview.info/xengthx1,34,34,0
09:04:2014,xlerator,http://goodpreview.info/xlerator,0,0,0
09:04:2014,xocigs,http://goodpreview.info/xocigs,65,65,0
09:04:2014,xtgenix,http://goodpreview.info/xtgenix,12979,12992,-13
09:04:2014,xtrememusclepro,http://goodpreview.info/xtrememusclepro,614,616,-2
09:04:2014,yaconsplash,http://goodpreview.info/yaconsplash,23,23,0
09:04:2014,yaconsyruporiginal,http://goodpreview.info/yaconsyruporiginal,95,95,0
09:04:2014,yaconsyrupsecret,http://goodpreview.info/yaconsyrupsecret,35,35,0
09:04:2014,yoloboost,http://goodpreview.info/yoloboost,15,18,-3
09:04:2014,youthkiteyecream,http://goodpreview.info/youthkiteyecream,246,246,0
