dt_today,sitetitle,sitelink,pre_click,new_clicks,difrnce
07:04:2014,11fruits,http://goodpreview.info/11fruits,200,200,0
07:04:2014,1285muscle,http://goodpreview.info/1285muscle,2865,2869,-4
07:04:2014,92trimgreencoffee,http://goodpreview.info/92trimgreencoffee,36,36,0
07:04:2014,Americig,http://goodpreview.info/Americig,442,449,-7
07:04:2014,Nuvagenic,http://goodpreview.info/Nuvagenic,1101,1102,-1
07:04:2014,Prolexin,http://goodpreview.info/Prolexin,831,850,-19
07:04:2014,SVELME,http://goodpreview.info/SVELME,791,796,-5
07:04:2014,SlimSpray,http://goodpreview.info/SlimSpray,277,280,-3
07:04:2014,acaiberryfresh,http://goodpreview.info/acaiberryfresh,98,98,0
07:04:2014,acainatural,http://goodpreview.info/acainatural,133,133,0
07:04:2014,acaiultralean,http://goodpreview.info/acaiultralean,131,132,-1
07:04:2014,advancedgarciniacambogia,http://goodpreview.info/advancedgarciniacambogia,884,884,0
07:04:2014,advancedgarciniacambogia-fr,http://goodpreview.info/advancedgarciniacambogia-fr,126,130,-4
07:04:2014,advancedgarciniacambogia1,http://goodpreview.info/advancedgarciniacambogia1,31,31,0
07:04:2014,advancedkrealkalyn,http://goodpreview.info/advancedkrealkalyn,146,146,0
07:04:2014,advancedpurecleanse,http://goodpreview.info/advancedpurecleanse,0,0,0
07:04:2014,advancedpurecleanse1,http://goodpreview.info/advancedpurecleanse1,32,34,-2
07:04:2014,africanmangoboost,http://goodpreview.info/africanmangoboost,118,118,0
07:04:2014,africanmangoprox,http://goodpreview.info/africanmangoprox,43,43,0
07:04:2014,africanmangopure,http://goodpreview.info/africanmangopure,76,77,-1
07:04:2014,aktiveam,http://goodpreview.info/aktiveam,1606,1607,-1
07:04:2014,aktivepm,http://goodpreview.info/aktivepm,2017,2028,-11
07:04:2014,alphajacked,http://goodpreview.info/alphajacked,773,773,0
07:04:2014,alphamaxplus,http://goodpreview.info/alphamaxplus,16,18,-2
07:04:2014,amazing,http://goodpreview.info/amazing,357,367,-10
07:04:2014,aminomuscle,http://goodpreview.info/aminomuscle,1200,1204,-4
07:04:2014,aminoprime,http://goodpreview.info/aminoprime,111,112,-1
07:04:2014,aminoprimexl,http://goodpreview.info/aminoprimexl,288,288,0
07:04:2014,anabolicrx24,http://goodpreview.info/anabolicrx24,18158,18401,-243
07:04:2014,anatomyx5,http://goodpreview.info/anatomyx5,3,3,0
07:04:2014,androsolve,http://goodpreview.info/androsolve,1477,1478,-1
07:04:2014,androx,http://goodpreview.info/androx,13709,13785,-76
07:04:2014,anoradrol,http://goodpreview.info/anoradrol,217,218,-1
07:04:2014,auravie,http://goodpreview.info/auravie,104,105,-1
07:04:2014,authenticgreencoffee,http://goodpreview.info/authenticgreencoffee,240,240,0
07:04:2014,beaudify,http://goodpreview.info/beaudify,73,75,-2
07:04:2014,beautefxbbcream,http://goodpreview.info/beautefxbbcream,2,3,-1
07:04:2014,beautynectarcollagen,http://goodpreview.info/beautynectarcollagen,133,133,0
07:04:2014,beddefense,http://goodpreview.info/beddefense,27,28,-1
07:04:2014,bellagenix,http://goodpreview.info/bellagenix,138,138,0
07:04:2014,bellalabs,http://goodpreview.info/bellalabs,8,8,0
07:04:2014,bellaplex,http://goodpreview.info/bellaplex,6,7,-1
07:04:2014,beriultimatepro,http://goodpreview.info/beriultimatepro,68,68,0
07:04:2014,berrythin,http://goodpreview.info/berrythin,330,332,-2
07:04:2014,betaalaninemax,http://goodpreview.info/betaalaninemax,0,0,0
07:04:2014,betaalaninextreme,http://goodpreview.info/betaalaninextreme,18,18,0
07:04:2014,beyondraspberry,http://goodpreview.info/beyondraspberry,75,75,0
07:04:2014,biohealthgarciniacambogia,http://goodpreview.info/biohealthgarciniacambogia,3591,3618,-27
07:04:2014,biomelt,http://goodpreview.info/biomelt,348,355,-7
07:04:2014,blastxl,http://goodpreview.info/blastxl,167,167,0
07:04:2014,bodycleanseplus,http://goodpreview.info/bodycleanseplus,66,66,0
07:04:2014,bodywrap,http://goodpreview.info/bodywrap,207,207,0
07:04:2014,breakfree,http://goodpreview.info/breakfree,111,112,-1
07:04:2014,cambogiatrim,http://goodpreview.info/cambogiatrim,598,598,0
07:04:2014,capsicum,http://goodpreview.info/capsicum,139,140,-1
07:04:2014,celebritycleanser,http://goodpreview.info/celebritycleanser,135,152,-17
07:04:2014,celebrityraspberry,http://goodpreview.info/celebrityraspberry,144,144,0
07:04:2014,cellanafricanmango,http://goodpreview.info/cellanafricanmango,259,263,-4
07:04:2014,cellogicaskin,http://goodpreview.info/cellogicaskin,50,50,0
07:04:2014,centrislim,http://goodpreview.info/centrislim,199,199,0
07:04:2014,certifiedgreencoffee,http://goodpreview.info/certifiedgreencoffee,149,149,0
07:04:2014,certifiedpuregreencoffee,http://goodpreview.info/certifiedpuregreencoffee,19,19,0
07:04:2014,chiocegreencoffee,http://goodpreview.info/chiocegreencoffee,545,545,0
07:04:2014,choicegreencoffee,http://goodpreview.info/choicegreencoffee,370,378,-8
07:04:2014,cleansefx,http://goodpreview.info/cleansefx,284,314,-30
07:04:2014,cleanseplus,http://goodpreview.info/cleanseplus,405,431,-26
07:04:2014,cleanseplus1,http://goodpreview.info/cleanseplus1,0,0,0
07:04:2014,cleansepremium,http://goodpreview.info/cleansepremium,15,15,0
07:04:2014,cleansewonder,http://goodpreview.info/cleansewonder,205,206,-1
07:04:2014,cleansextrem,http://goodpreview.info/cleansextrem,182,234,-52
07:04:2014,cleantrim,http://goodpreview.info/cleantrim,228,228,0
07:04:2014,clearcleansepro,http://goodpreview.info/clearcleansepro,108,111,-3
07:04:2014,clearsmoke,http://goodpreview.info/clearsmoke,177,177,0
07:04:2014,codered7,http://goodpreview.info/codered7,307,312,-5
07:04:2014,coleanse,http://goodpreview.info/coleanse,124,124,0
07:04:2014,collaton,http://goodpreview.info/collaton,88,88,0
07:04:2014,colocleansepro,http://goodpreview.info/colocleansepro,1,1,0
07:04:2014,coloncleansetotal,http://goodpreview.info/coloncleansetotal,20,20,0
07:04:2014,colonpurecleanse,http://goodpreview.info/colonpurecleanse,131,132,-1
07:04:2014,colothin,http://goodpreview.info/colothin,989,991,-2
07:04:2014,completecoffeecleanse,http://goodpreview.info/completecoffeecleanse,1982,1982,0
07:04:2014,complexiderm,http://goodpreview.info/complexiderm,105,105,0
07:04:2014,corecutter,http://goodpreview.info/corecutter,38,38,0
07:04:2014,csorex,http://goodpreview.info/csorex,179,179,0
07:04:2014,dailyfacelift,http://goodpreview.info/dailyfacelift,99,99,0
07:04:2014,dailyfacestemcelltechnology,http://goodpreview.info/dailyfacestemcelltechnology,196,196,0
07:04:2014,dailypowercleanse,http://goodpreview.info/dailypowercleanse,118,121,-3
07:04:2014,deerantlerxtreme,http://goodpreview.info/deerantlerxtreme,131,132,-1
07:04:2014,dermarose,http://goodpreview.info/dermarose,112,112,0
07:04:2014,dermaset,http://goodpreview.info/dermaset,51,51,0
07:04:2014,dermpure,http://goodpreview.info/dermpure,80,80,0
07:04:2014,dietgreencoffeebean,http://goodpreview.info/dietgreencoffeebean,312,312,0
07:04:2014,drillpill,http://goodpreview.info/drillpill,457,458,-1
07:04:2014,elevategf,http://goodpreview.info/elevategf,174,174,0
07:04:2014,elier,http://goodpreview.info/elier,50,50,0
07:04:2014,elierskincare,http://goodpreview.info/elierskincare,41,41,0
07:04:2014,elitetest360,http://goodpreview.info/elitetest360,448,458,-10
07:04:2014,emeraldluxecig,http://goodpreview.info/emeraldluxecig,113,113,0
07:04:2014,enduros,http://goodpreview.info/enduros,971,979,-8
07:04:2014,envigra,http://goodpreview.info/envigra,105,106,-1
07:04:2014,estrodetox,http://goodpreview.info/estrodetox,99,99,0
07:04:2014,extentxl,http://goodpreview.info/extentxl,176,176,0
07:04:2014,fembalance,http://goodpreview.info/fembalance,17,17,0
07:04:2014,flawlessraspberryketone,http://goodpreview.info/flawlessraspberryketone,84,84,0
07:04:2014,formulat10,http://goodpreview.info/formulat10,1508,1513,-5
07:04:2014,garcinaiawow1,http://goodpreview.info/garcinaiawow1,57,63,-6
07:04:2014,garciniacambogia,http://goodpreview.info/garciniacambogia,254,299,-45
07:04:2014,garciniacambogia1000,http://goodpreview.info/garciniacambogia1000,62,62,0
07:04:2014,garciniacambogiaelite,http://goodpreview.info/garciniacambogiaelite,5269,5291,-22
07:04:2014,garciniacambogiafatbuster,http://goodpreview.info/garciniacambogiafatbuster,90,90,0
07:04:2014,garciniacambogiamax,http://goodpreview.info/garciniacambogiamax,2408,2408,0
07:04:2014,garciniacambogiamiracle,http://goodpreview.info/garciniacambogiamiracle,129,129,0
07:04:2014,garciniacambogiapremium,http://goodpreview.info/garciniacambogiapremium,1076,1076,0
07:04:2014,garciniacambogiapureextract,http://goodpreview.info/garciniacambogiapureextract,143,144,-1
07:04:2014,garciniacambogiapureselect,http://goodpreview.info/garciniacambogiapureselect,596,599,-3
07:04:2014,garciniacambogiasupreme,http://goodpreview.info/garciniacambogiasupreme,3231,3316,-85
07:04:2014,garciniacambogiatoday,http://goodpreview.info/garciniacambogiatoday,134,136,-2
07:04:2014,garciniacambogiaultra,http://goodpreview.info/garciniacambogiaultra,360,362,-2
07:04:2014,garciniaforte,http://goodpreview.info/garciniaforte,45,55,-10
07:04:2014,garciniafreetrial,http://goodpreview.info/garciniafreetrial,68,69,-1
07:04:2014,garciniagreen,http://goodpreview.info/garciniagreen,837,841,-4
07:04:2014,garciniapureelite1,http://goodpreview.info/garciniapureelite1,1,1,0
07:04:2014,garciniatoday,http://goodpreview.info/garciniatoday,0,0,0
07:04:2014,garciniatotal,http://goodpreview.info/garciniatotal,92,95,-3
07:04:2014,garciniawow,http://goodpreview.info/garciniawow,949,970,-21
07:04:2014,garcinium,http://goodpreview.info/garcinium,11,22,-11
07:04:2014,gc7x,http://goodpreview.info/gc7x,102,102,0
07:04:2014,gc7xgreencoffee,http://goodpreview.info/gc7xgreencoffee,0,0,0
07:04:2014,gcbultra,http://goodpreview.info/gcbultra,52,52,0
07:04:2014,gcbx,http://goodpreview.info/gcbx,17082,17085,-3
07:04:2014,gcbx1,http://goodpreview.info/gcbx1,196,196,0
07:04:2014,gcspeedslim,http://goodpreview.info/gcspeedslim,5746,5783,-37
07:04:2014,gcultra,http://goodpreview.info/gcultra,136,136,0
07:04:2014,gcultragarcinia,http://goodpreview.info/gcultragarcinia,4,4,0
07:04:2014,geneme,http://goodpreview.info/geneme,39,40,-1
07:04:2014,getnaturalgarcinia,http://goodpreview.info/getnaturalgarcinia,40,41,-1
07:04:2014,greencoffeeadvanced,http://goodpreview.info/greencoffeeadvanced,181,181,0
07:04:2014,greencoffeebean8000,http://goodpreview.info/greencoffeebean8000,66,66,0
07:04:2014,greencoffeebody,http://goodpreview.info/greencoffeebody,33,33,0
07:04:2014,greencoffeeburn,http://goodpreview.info/greencoffeeburn,25,25,0
07:04:2014,greencoffeeextreme,http://goodpreview.info/greencoffeeextreme,84,84,0
07:04:2014,greencoffeemax,http://goodpreview.info/greencoffeemax,135,135,0
07:04:2014,greencoffeemaxx,http://goodpreview.info/greencoffeemaxx,3,4,-1
07:04:2014,greencoffeeoptimum,http://goodpreview.info/greencoffeeoptimum,122,123,-1
07:04:2014,greencoffeeprogram,http://goodpreview.info/greencoffeeprogram,0,0,0
07:04:2014,greencoffeeultraslim,http://goodpreview.info/greencoffeeultraslim,206,207,-1
07:04:2014,greentonepro,http://goodpreview.info/greentonepro,308,309,-1
07:04:2014,healthetrimgarcinia,http://goodpreview.info/healthetrimgarcinia,151,151,0
07:04:2014,healthychoicegc,http://goodpreview.info/healthychoicegc,746,747,-1
07:04:2014,horsepowerplusxxxl,http://goodpreview.info/horsepowerplusxxxl,232,245,-13
07:04:2014,hugegenic,http://goodpreview.info/hugegenic,323,329,-6
07:04:2014,hydrellatone,http://goodpreview.info/hydrellatone,102,103,-1
07:04:2014,hydrocollagen,http://goodpreview.info/hydrocollagen,44,44,0
07:04:2014,hydroderm,http://goodpreview.info/hydroderm,46,47,-1
07:04:2014,hyperfuel9x,http://goodpreview.info/hyperfuel9x,1921,1932,-11
07:04:2014,illuminatedteeth,http://goodpreview.info/illuminatedteeth,41,44,-3
07:04:2014,instantwrinklerepair,http://goodpreview.info/instantwrinklerepair,18,18,0
07:04:2014,iqderma,http://goodpreview.info/iqderma,418,419,-1
07:04:2014,iqdermaessen,http://goodpreview.info/iqdermaessen,0,0,0
07:04:2014,ketoneoptimum,http://goodpreview.info/ketoneoptimum,154,155,-1
07:04:2014,kleanslim,http://goodpreview.info/kleanslim,100,100,0
07:04:2014,lacreme,http://goodpreview.info/lacreme,816,0,816
07:04:2014,leanmuscleformula,http://goodpreview.info/leanmuscleformula,34,48,-14
07:04:2014,ledermeluxe,http://goodpreview.info/ledermeluxe,185,185,0
07:04:2014,leparfait,http://goodpreview.info/leparfait,21,21,0
07:04:2014,leparisehydragold,http://goodpreview.info/leparisehydragold,3,3,0
07:04:2014,levela,http://goodpreview.info/levela,105,105,0
07:04:2014,lifedetox,http://goodpreview.info/lifedetox,145,146,-1
07:04:2014,liftserumpro,http://goodpreview.info/liftserumpro,188,189,-1
07:04:2014,liposlender,http://goodpreview.info/liposlender,25,25,0
07:04:2014,liposlim,http://goodpreview.info/liposlim,1874,1878,-4
07:04:2014,liposom,http://goodpreview.info/liposom,62,62,0
07:04:2014,liveskinny,http://goodpreview.info/liveskinny,232,232,0
07:04:2014,lumahydrate,http://goodpreview.info/lumahydrate,399,406,-7
07:04:2014,lumarepair,http://goodpreview.info/lumarepair,475,483,-8
07:04:2014,lunathin,http://goodpreview.info/lunathin,123,123,0
07:04:2014,luxoderm,http://goodpreview.info/luxoderm,209,210,-1
07:04:2014,lysocleanse,http://goodpreview.info/lysocleanse,1782,1794,-12
07:04:2014,maxdetoxpro,http://goodpreview.info/maxdetoxpro,574,574,0
07:04:2014,maxgarciniaburn,http://goodpreview.info/maxgarciniaburn,455,455,0
07:04:2014,maximumshred,http://goodpreview.info/maximumshred,1522,1523,-1
07:04:2014,maxrobust,http://goodpreview.info/maxrobust,257,259,-2
07:04:2014,maxrobustxtreme,http://goodpreview.info/maxrobustxtreme,521,522,-1
07:04:2014,mightyraspberryketone,http://goodpreview.info/mightyraspberryketone,5107,5107,0
07:04:2014,miraclegarciniacambogia,http://goodpreview.info/miraclegarciniacambogia,487,492,-5
07:04:2014,miraclegreencoffee,http://goodpreview.info/miraclegreencoffee,529,539,-10
07:04:2014,miraclesaffron,http://goodpreview.info/miraclesaffron,50,50,0
07:04:2014,mitoslim,http://goodpreview.info/mitoslim,2055,2059,-4
07:04:2014,musclefactorx,http://goodpreview.info/musclefactorx,1440,1441,-1
07:04:2014,musclefactorx-1,http://goodpreview.info/musclefactorx-1,22,22,0
07:04:2014,musclekingpro,http://goodpreview.info/musclekingpro,501,501,0
07:04:2014,musclemaxextreme,http://goodpreview.info/musclemaxextreme,137,137,0
07:04:2014,muscleplus,http://goodpreview.info/muscleplus,142,143,-1
07:04:2014,musclerevolutionpro,http://goodpreview.info/musclerevolutionpro,1411,1420,-9
07:04:2014,musclerevx,http://goodpreview.info/musclerevx,91,95,-4
07:04:2014,musclerevxtreme,http://goodpreview.info/musclerevxtreme,58,59,-1
07:04:2014,musclexlerator,http://goodpreview.info/musclexlerator,26,27,-1
07:04:2014,musclexmax,http://goodpreview.info/musclexmax,1436,1437,-1
07:04:2014,musclexmax1,http://goodpreview.info/musclexmax1,278,278,0
07:04:2014,musclezx90,http://goodpreview.info/musclezx90,4974,4992,-18
07:04:2014,naturalcleanse,http://goodpreview.info/naturalcleanse,8018,8025,-7
07:04:2014,naturalgarciniacambogia,http://goodpreview.info/naturalgarciniacambogia,2767,2768,-1
07:04:2014,naturalgreencoffee,http://goodpreview.info/naturalgreencoffee,8,8,0
07:04:2014,naturalhealthgarcinia,http://goodpreview.info/naturalhealthgarcinia,52,53,-1
07:04:2014,naturalpurecleanse,http://goodpreview.info/naturalpurecleanse,1558,1568,-10
07:04:2014,nauseam,http://goodpreview.info/nauseam,135,135,0
07:04:2014,nauseamplus,http://goodpreview.info/nauseamplus,0,0,0
07:04:2014,nextrim,http://goodpreview.info/nextrim,1730,1734,-4
07:04:2014,nitricmusclemax,http://goodpreview.info/nitricmusclemax,13836,14009,-173
07:04:2014,nitrofocusno3,http://goodpreview.info/nitrofocusno3,85,91,-6
07:04:2014,niwali,http://goodpreview.info/niwali,813,823,-10
07:04:2014,no2explodeextreme,http://goodpreview.info/no2explodeextreme,162,163,-1
07:04:2014,no2extremerush,http://goodpreview.info/no2extremerush,1301,1306,-5
07:04:2014,noflameecigs,http://goodpreview.info/noflameecigs,350,350,0
07:04:2014,nuclearno,http://goodpreview.info/nuclearno,367,367,0
07:04:2014,nuetrim,http://goodpreview.info/nuetrim,660,660,0
07:04:2014,nutragreencoffee,http://goodpreview.info/nutragreencoffee,3564,3570,-6
07:04:2014,nutrapuregarcinia,http://goodpreview.info/nutrapuregarcinia,211,211,0
07:04:2014,nutratoneplus,http://goodpreview.info/nutratoneplus,1003,1004,-1
07:04:2014,nutriberryslim,http://goodpreview.info/nutriberryslim,1140,1162,-22
07:04:2014,nuvoryn,http://goodpreview.info/nuvoryn,22,22,0
07:04:2014,optimalstack,http://goodpreview.info/optimalstack,1653,1657,-4
07:04:2014,optimummuscle,http://goodpreview.info/optimummuscle,207,207,0
07:04:2014,organicgreencoffee,http://goodpreview.info/organicgreencoffee,91,91,0
07:04:2014,organicwhitekidneybean,http://goodpreview.info/organicwhitekidneybean,91,91,0
07:04:2014,orviax,http://goodpreview.info/orviax,89,89,0
07:04:2014,oxitamin,http://goodpreview.info/oxitamin,147,148,-1
07:04:2014,phtytoceramides,http://goodpreview.info/phtytoceramides,816,817,-1
07:04:2014,powerigf,http://goodpreview.info/powerigf,1816,1834,-18
07:04:2014,powerpumpxl,http://goodpreview.info/powerpumpxl,369,369,0
07:04:2014,powerup,http://goodpreview.info/powerup,119,119,0
07:04:2014,premiermangocleanse,http://goodpreview.info/premiermangocleanse,513,515,-2
07:04:2014,premiumcleanse,http://goodpreview.info/premiumcleanse,2760,2771,-11
07:04:2014,premiumgarciniacambogia,http://goodpreview.info/premiumgarciniacambogia,401,402,-1
07:04:2014,premiumgarciniaextract,http://goodpreview.info/premiumgarciniaextract,713,714,-1
07:04:2014,premiumgreencoffee,http://goodpreview.info/premiumgreencoffee,119,119,0
07:04:2014,premiumgreencoffee800,http://goodpreview.info/premiumgreencoffee800,108,108,0
07:04:2014,premiumraspberryketone,http://goodpreview.info/premiumraspberryketone,43,43,0
07:04:2014,primalitegarciniaextract,http://goodpreview.info/primalitegarciniaextract,735,743,-8
07:04:2014,progain350,http://goodpreview.info/progain350,231,240,-9
07:04:2014,prograce,http://goodpreview.info/prograce,3,3,0
07:04:2014,promusclecomplex,http://goodpreview.info/promusclecomplex,49,49,0
07:04:2014,propowercleanse,http://goodpreview.info/propowercleanse,1094,1149,-55
07:04:2014,pureberrymax,http://goodpreview.info/pureberrymax,215,215,0
07:04:2014,purecleansehealth,http://goodpreview.info/purecleansehealth,110,110,0
07:04:2014,purecollagen,http://goodpreview.info/purecollagen,2225,2225,0
07:04:2014,puregarciniacambogia,http://goodpreview.info/puregarciniacambogia,1212,1214,-2
07:04:2014,puregarciniaslim,http://goodpreview.info/puregarciniaslim,167,168,-1
07:04:2014,puregreencoffeebeanextract,http://goodpreview.info/puregreencoffeebeanextract,2714,2721,-7
07:04:2014,puregreencoffeemaxima,http://goodpreview.info/puregreencoffeemaxima,37,37,0
07:04:2014,puregriffonia,http://goodpreview.info/puregriffonia,96,96,0
07:04:2014,pureketoneslim,http://goodpreview.info/pureketoneslim,32,32,0
07:04:2014,purelifeclanse,http://goodpreview.info/purelifeclanse,9,11,-2
07:04:2014,puremusclepro,http://goodpreview.info/puremusclepro,1808,1808,0
07:04:2014,purenaturalcleanser,http://goodpreview.info/purenaturalcleanser,477,478,-1
07:04:2014,purephytoceramides,http://goodpreview.info/purephytoceramides,74,75,-1
07:04:2014,pureraspberryketonepremium,http://goodpreview.info/pureraspberryketonepremium,63,63,0
07:04:2014,puresaffronslim,http://goodpreview.info/puresaffronslim,423,423,0
07:04:2014,pureslim57,http://goodpreview.info/pureslim57,126,126,0
07:04:2014,purgarciniacambogia,http://goodpreview.info/purgarciniacambogia,157,157,0
07:04:2014,purgreencoffee,http://goodpreview.info/purgreencoffee,1626,1626,0
07:04:2014,purifyre,http://goodpreview.info/purifyre,244,244,0
07:04:2014,purifyregreencoffee,http://goodpreview.info/purifyregreencoffee,0,0,0
07:04:2014,raspberryhealth,http://goodpreview.info/raspberryhealth,63,66,-3
07:04:2014,raspberryketoneblast,http://goodpreview.info/raspberryketoneblast,4238,4309,-71
07:04:2014,raspberryketoned,http://goodpreview.info/raspberryketoned,2,4,-2
07:04:2014,raspberryketoneoptimum,http://goodpreview.info/raspberryketoneoptimum,5,5,0
07:04:2014,raspberryketonepremium,http://goodpreview.info/raspberryketonepremium,79,79,0
07:04:2014,raspberryketonepure,http://goodpreview.info/raspberryketonepure,2,2,0
07:04:2014,raspberryketonethin,http://goodpreview.info/raspberryketonethin,26,41,-15
07:04:2014,raspberryslimplus,http://goodpreview.info/raspberryslimplus,127,127,0
07:04:2014,refuelextreme,http://goodpreview.info/refuelextreme,492,494,-2
07:04:2014,regalecig,http://goodpreview.info/regalecig,372,375,-3
07:04:2014,regalecigs,http://goodpreview.info/regalecigs,41,41,0
07:04:2014,rejuvaglow,http://goodpreview.info/rejuvaglow,71,71,0
07:04:2014,rejuveneyemax,http://goodpreview.info/rejuveneyemax,73,85,-12
07:04:2014,rellift,http://goodpreview.info/rellift,29,29,0
07:04:2014,renovo,http://goodpreview.info/renovo,38,38,0
07:04:2014,restiflex,http://goodpreview.info/restiflex,63,64,-1
07:04:2014,revitalize,http://goodpreview.info/revitalize,25,26,-1
07:04:2014,revitatone,http://goodpreview.info/revitatone,8961,8999,-38
07:04:2014,revolutionaryraspberryketone,http://goodpreview.info/revolutionaryraspberryketone,65,65,0
07:04:2014,revoreplex,http://goodpreview.info/revoreplex,9,10,-1
07:04:2014,revtesttestosterone,http://goodpreview.info/revtesttestosterone,1593,1593,0
07:04:2014,rippedmusclex,http://goodpreview.info/rippedmusclex,191,197,-6
07:04:2014,rippedxburn,http://goodpreview.info/rippedxburn,186,187,-1
07:04:2014,sacredarganoil,http://goodpreview.info/sacredarganoil,49,49,0
07:04:2014,safercolon,http://goodpreview.info/safercolon,3163,3252,-89
07:04:2014,saffronextractpremium,http://goodpreview.info/saffronextractpremium,105,105,0
07:04:2014,saffronextractselect,http://goodpreview.info/saffronextractselect,1368,1369,-1
07:04:2014,saffronselect,http://goodpreview.info/saffronselect,74,74,0
07:04:2014,secretgreencoffee,http://goodpreview.info/secretgreencoffee,263,263,0
07:04:2014,simpleantiaging,http://goodpreview.info/simpleantiaging,231,231,0
07:04:2014,simplygarcinia,http://goodpreview.info/simplygarcinia,1116,1136,-20
07:04:2014,skinlift,http://goodpreview.info/skinlift,2147,2149,-2
07:04:2014,slendera,http://goodpreview.info/slendera,15,15,0
07:04:2014,slenderagc-1,http://goodpreview.info/slenderagc-1,403,405,-2
07:04:2014,slimatrex,http://goodpreview.info/slimatrex,618,618,0
07:04:2014,slimhelper,http://goodpreview.info/slimhelper,246,247,-1
07:04:2014,slimher,http://goodpreview.info/slimher,171,171,0
07:04:2014,slimmeryougarcinia,http://goodpreview.info/slimmeryougarcinia,0,0,0
07:04:2014,slimtropical,http://goodpreview.info/slimtropical,808,808,0
07:04:2014,slimtropicalmx,http://goodpreview.info/slimtropicalmx,135,135,0
07:04:2014,slimzenu,http://goodpreview.info/slimzenu,201,201,0
07:04:2014,smokestarecig,http://goodpreview.info/smokestarecig,553,556,-3
07:04:2014,solpriaxtreme,http://goodpreview.info/solpriaxtreme,2784,2792,-8
07:04:2014,sorepressin,http://goodpreview.info/sorepressin,6,6,0
07:04:2014,speedtrimxs,http://goodpreview.info/speedtrimxs,95,95,0
07:04:2014,splendyr,http://goodpreview.info/splendyr,1275,1276,-1
07:04:2014,splendyrantiaging,http://goodpreview.info/splendyrantiaging,51,51,0
07:04:2014,superacaicleanse,http://goodpreview.info/superacaicleanse,21,22,-1
07:04:2014,supercleansetotal,http://goodpreview.info/supercleansetotal,71,75,-4
07:04:2014,supergreencoffee,http://goodpreview.info/supergreencoffee,11,11,0
07:04:2014,supergreencoffeebean,http://goodpreview.info/supergreencoffeebean,20,20,0
07:04:2014,superiormusclex,http://goodpreview.info/superiormusclex,14,17,-3
07:04:2014,superiorvelvet,http://goodpreview.info/superiorvelvet,1,1,0
07:04:2014,superyacon1000,http://goodpreview.info/superyacon1000,21,23,-2
07:04:2014,supracleanse350,http://goodpreview.info/supracleanse350,0,0,0
07:04:2014,supragreencoffee,http://goodpreview.info/supragreencoffee,923,929,-6
07:04:2014,supragreencoffeebean,http://goodpreview.info/supragreencoffeebean,0,0,0
07:04:2014,surelyyoung,http://goodpreview.info/surelyyoung,29,29,0
07:04:2014,swissrose,http://goodpreview.info/swissrose,341,341,0
07:04:2014,swolekreate,http://goodpreview.info/swolekreate,193,193,0
07:04:2014,syneocell,http://goodpreview.info/syneocell,56,57,-1
07:04:2014,t-force,http://goodpreview.info/t-force,196,199,-3
07:04:2014,testforcextreme,http://goodpreview.info/testforcextreme,491,491,0
07:04:2014,testoforce,http://goodpreview.info/testoforce,21,21,0
07:04:2014,testorushrx,http://goodpreview.info/testorushrx,41,41,0
07:04:2014,testosteronemax,http://goodpreview.info/testosteronemax,329,330,-1
07:04:2014,testoxl,http://goodpreview.info/testoxl,1478,1481,-3
07:04:2014,thinmagic,http://goodpreview.info/thinmagic,272,275,-3
07:04:2014,thinmagicmax,http://goodpreview.info/thinmagicmax,0,0,0
07:04:2014,thinsport,http://goodpreview.info/thinsport,212,212,0
07:04:2014,titaniumprox,http://goodpreview.info/titaniumprox,0,0,0
07:04:2014,totalbodyfresh,http://goodpreview.info/totalbodyfresh,124,125,-1
07:04:2014,trigx2,http://goodpreview.info/trigx2,14,14,0
07:04:2014,trimaleana,http://goodpreview.info/trimaleana,142,142,0
07:04:2014,trimatol,http://goodpreview.info/trimatol,123,123,0
07:04:2014,trimblendgarciniacambogia,http://goodpreview.info/trimblendgarciniacambogia,76,76,0
07:04:2014,triminexgarciniacambogia,http://goodpreview.info/triminexgarciniacambogia,90,91,-1
07:04:2014,triminexgreencoffee,http://goodpreview.info/triminexgreencoffee,56,57,-1
07:04:2014,tripleeffectseyeserum,http://goodpreview.info/tripleeffectseyeserum,613,618,-5
07:04:2014,turboextracut,http://goodpreview.info/turboextracut,162,162,0
07:04:2014,turboshred,http://goodpreview.info/turboshred,100,100,0
07:04:2014,ultimategarcinia,http://goodpreview.info/ultimategarcinia,165,165,0
07:04:2014,ultramaxtestosterone,http://goodpreview.info/ultramaxtestosterone,33,33,0
07:04:2014,ultrapurecoloncleanse,http://goodpreview.info/ultrapurecoloncleanse,4,5,-1
07:04:2014,ultraraspberryketone,http://goodpreview.info/ultraraspberryketone,418,418,0
07:04:2014,velora,http://goodpreview.info/velora,23,23,0
07:04:2014,velveskin,http://goodpreview.info/velveskin,17,18,-1
07:04:2014,vencleanse,http://goodpreview.info/vencleanse,431,431,0
07:04:2014,viarex,http://goodpreview.info/viarex,605,608,-3
07:04:2014,vitalifedetox,http://goodpreview.info/vitalifedetox,257,257,0
07:04:2014,vitalitygreencoffee,http://goodpreview.info/vitalitygreencoffee,85,85,0
07:04:2014,vitamax,http://goodpreview.info/vitamax,22,22,0
07:04:2014,vitolipo,http://goodpreview.info/vitolipo,1148,1149,-1
07:04:2014,vydox,http://goodpreview.info/vydox,313,315,-2
07:04:2014,wildraspberryketone,http://goodpreview.info/wildraspberryketone,182,188,-6
07:04:2014,wrinklesscream,http://goodpreview.info/wrinklesscream,291,293,-2
07:04:2014,xenaslim,http://goodpreview.info/xenaslim,41,42,-1
07:04:2014,xengthx1,http://goodpreview.info/xengthx1,34,34,0
07:04:2014,xlerator,http://goodpreview.info/xlerator,0,0,0
07:04:2014,xocigs,http://goodpreview.info/xocigs,65,65,0
07:04:2014,xtgenix,http://goodpreview.info/xtgenix,12963,12967,-4
07:04:2014,xtrememusclepro,http://goodpreview.info/xtrememusclepro,610,613,-3
07:04:2014,yaconsplash,http://goodpreview.info/yaconsplash,21,22,-1
07:04:2014,yaconsyruporiginal,http://goodpreview.info/yaconsyruporiginal,95,95,0
07:04:2014,yaconsyrupsecret,http://goodpreview.info/yaconsyrupsecret,34,34,0
07:04:2014,yoloboost,http://goodpreview.info/yoloboost,5,8,-3
07:04:2014,youthkiteyecream,http://goodpreview.info/youthkiteyecream,245,245,0
