dt_today,sitetitle,sitelink,pre_click,new_clicks,difrnce
03:04:2014,11fruits,http://goodpreview.info/11fruits,199,199,0
03:04:2014,1285muscle,http://goodpreview.info/1285muscle,2854,2856,-2
03:04:2014,92trimgreencoffee,http://goodpreview.info/92trimgreencoffee,35,35,0
03:04:2014,Americig,http://goodpreview.info/Americig,402,412,-10
03:04:2014,Nuvagenic,http://goodpreview.info/Nuvagenic,1099,1099,0
03:04:2014,Prolexin,http://goodpreview.info/Prolexin,716,743,-27
03:04:2014,SVELME,http://goodpreview.info/SVELME,789,789,0
03:04:2014,SlimSpray,http://goodpreview.info/SlimSpray,264,268,-4
03:04:2014,acaiberryfresh,http://goodpreview.info/acaiberryfresh,95,96,-1
03:04:2014,acainatural,http://goodpreview.info/acainatural,132,132,0
03:04:2014,acaiultralean,http://goodpreview.info/acaiultralean,129,129,0
03:04:2014,advancedgarciniacambogia,http://goodpreview.info/advancedgarciniacambogia,882,882,0
03:04:2014,advancedgarciniacambogia-fr,http://goodpreview.info/advancedgarciniacambogia-fr,107,114,-7
03:04:2014,advancedgarciniacambogia1,http://goodpreview.info/advancedgarciniacambogia1,19,23,-4
03:04:2014,advancedkrealkalyn,http://goodpreview.info/advancedkrealkalyn,145,146,-1
03:04:2014,advancedpurecleanse,http://goodpreview.info/advancedpurecleanse,0,0,0
03:04:2014,advancedpurecleanse1,http://goodpreview.info/advancedpurecleanse1,19,23,-4
03:04:2014,africanmangoboost,http://goodpreview.info/africanmangoboost,118,118,0
03:04:2014,africanmangoprox,http://goodpreview.info/africanmangoprox,42,42,0
03:04:2014,africanmangopure,http://goodpreview.info/africanmangopure,76,76,0
03:04:2014,aktiveam,http://goodpreview.info/aktiveam,1598,1603,-5
03:04:2014,aktivepm,http://goodpreview.info/aktivepm,1990,1994,-4
03:04:2014,alphajacked,http://goodpreview.info/alphajacked,771,772,-1
03:04:2014,alphamaxplus,http://goodpreview.info/alphamaxplus,11,13,-2
03:04:2014,amazing,http://goodpreview.info/amazing,308,317,-9
03:04:2014,aminomuscle,http://goodpreview.info/aminomuscle,1190,1193,-3
03:04:2014,aminoprime,http://goodpreview.info/aminoprime,108,110,-2
03:04:2014,aminoprimexl,http://goodpreview.info/aminoprimexl,279,284,-5
03:04:2014,anabolicrx24,http://goodpreview.info/anabolicrx24,17170,17386,-216
03:04:2014,anatomyx5,http://goodpreview.info/anatomyx5,3,3,0
03:04:2014,androsolve,http://goodpreview.info/androsolve,1473,1473,0
03:04:2014,androx,http://goodpreview.info/androx,12597,13200,-603
03:04:2014,anoradrol,http://goodpreview.info/anoradrol,213,214,-1
03:04:2014,auravie,http://goodpreview.info/auravie,104,104,0
03:04:2014,authenticgreencoffee,http://goodpreview.info/authenticgreencoffee,240,240,0
03:04:2014,beaudify,http://goodpreview.info/beaudify,72,73,-1
03:04:2014,beautefxbbcream,http://goodpreview.info/beautefxbbcream,2,2,0
03:04:2014,beautynectarcollagen,http://goodpreview.info/beautynectarcollagen,132,132,0
03:04:2014,beddefense,http://goodpreview.info/beddefense,25,27,-2
03:04:2014,bellagenix,http://goodpreview.info/bellagenix,138,138,0
03:04:2014,bellalabs,http://goodpreview.info/bellalabs,7,8,-1
03:04:2014,bellaplex,http://goodpreview.info/bellaplex,110,112,-2
03:04:2014,beriultimatepro,http://goodpreview.info/beriultimatepro,68,68,0
03:04:2014,berrythin,http://goodpreview.info/berrythin,324,325,-1
03:04:2014,betaalaninemax,http://goodpreview.info/betaalaninemax,0,0,0
03:04:2014,betaalaninextreme,http://goodpreview.info/betaalaninextreme,16,16,0
03:04:2014,beyondraspberry,http://goodpreview.info/beyondraspberry,75,75,0
03:04:2014,biohealthgarciniacambogia,http://goodpreview.info/biohealthgarciniacambogia,3386,3426,-40
03:04:2014,biomelt,http://goodpreview.info/biomelt,315,330,-15
03:04:2014,blastxl,http://goodpreview.info/blastxl,153,156,-3
03:04:2014,bodycleanseplus,http://goodpreview.info/bodycleanseplus,66,66,0
03:04:2014,bodywrap,http://goodpreview.info/bodywrap,206,206,0
03:04:2014,breakfree,http://goodpreview.info/breakfree,111,111,0
03:04:2014,cambogiatrim,http://goodpreview.info/cambogiatrim,598,598,0
03:04:2014,capsicum,http://goodpreview.info/capsicum,139,139,0
03:04:2014,celebritycleanser,http://goodpreview.info/celebritycleanser,65,83,-18
03:04:2014,celebrityraspberry,http://goodpreview.info/celebrityraspberry,135,136,-1
03:04:2014,cellanafricanmango,http://goodpreview.info/cellanafricanmango,243,248,-5
03:04:2014,cellogicaskin,http://goodpreview.info/cellogicaskin,46,47,-1
03:04:2014,centrislim,http://goodpreview.info/centrislim,199,199,0
03:04:2014,certifiedgreencoffee,http://goodpreview.info/certifiedgreencoffee,147,149,-2
03:04:2014,certifiedpuregreencoffee,http://goodpreview.info/certifiedpuregreencoffee,19,19,0
03:04:2014,chiocegreencoffee,http://goodpreview.info/chiocegreencoffee,545,545,0
03:04:2014,choicegreencoffee,http://goodpreview.info/choicegreencoffee,339,345,-6
03:04:2014,cleansefx,http://goodpreview.info/cleansefx,76,143,-67
03:04:2014,cleanseplus,http://goodpreview.info/cleanseplus,369,378,-9
03:04:2014,cleanseplus1,http://goodpreview.info/cleanseplus1,0,0,0
03:04:2014,cleansepremium,http://goodpreview.info/cleansepremium,15,15,0
03:04:2014,cleansewonder,http://goodpreview.info/cleansewonder,195,195,0
03:04:2014,cleansextrem,http://goodpreview.info/cleansextrem,43,77,-34
03:04:2014,cleantrim,http://goodpreview.info/cleantrim,226,226,0
03:04:2014,clearcleansepro,http://goodpreview.info/clearcleansepro,107,108,-1
03:04:2014,clearsmoke,http://goodpreview.info/clearsmoke,173,174,-1
03:04:2014,codered7,http://goodpreview.info/codered7,296,300,-4
03:04:2014,coleanse,http://goodpreview.info/coleanse,123,123,0
03:04:2014,collaton,http://goodpreview.info/collaton,88,88,0
03:04:2014,colocleansepro,http://goodpreview.info/colocleansepro,0,0,0
03:04:2014,coloncleansetotal,http://goodpreview.info/coloncleansetotal,12,14,-2
03:04:2014,colonpurecleanse,http://goodpreview.info/colonpurecleanse,130,131,-1
03:04:2014,colothin,http://goodpreview.info/colothin,987,988,-1
03:04:2014,completecoffeecleanse,http://goodpreview.info/completecoffeecleanse,1971,1976,-5
03:04:2014,complexiderm,http://goodpreview.info/complexiderm,103,103,0
03:04:2014,corecutter,http://goodpreview.info/corecutter,32,35,-3
03:04:2014,csorex,http://goodpreview.info/csorex,174,174,0
03:04:2014,dailyfacelift,http://goodpreview.info/dailyfacelift,92,92,0
03:04:2014,dailyfacestemcelltechnology,http://goodpreview.info/dailyfacestemcelltechnology,193,193,0
03:04:2014,dailypowercleanse,http://goodpreview.info/dailypowercleanse,109,112,-3
03:04:2014,deerantlerxtreme,http://goodpreview.info/deerantlerxtreme,130,131,-1
03:04:2014,dermarose,http://goodpreview.info/dermarose,112,112,0
03:04:2014,dermaset,http://goodpreview.info/dermaset,49,51,-2
03:04:2014,dermpure,http://goodpreview.info/dermpure,80,80,0
03:04:2014,dietgreencoffeebean,http://goodpreview.info/dietgreencoffeebean,305,310,-5
03:04:2014,drillpill,http://goodpreview.info/drillpill,451,454,-3
03:04:2014,elevategf,http://goodpreview.info/elevategf,174,174,0
03:04:2014,elier,http://goodpreview.info/elier,50,50,0
03:04:2014,elierskincare,http://goodpreview.info/elierskincare,40,40,0
03:04:2014,elitetest360,http://goodpreview.info/elitetest360,399,408,-9
03:04:2014,emeraldluxecig,http://goodpreview.info/emeraldluxecig,112,112,0
03:04:2014,enduros,http://goodpreview.info/enduros,949,953,-4
03:04:2014,envigra,http://goodpreview.info/envigra,103,105,-2
03:04:2014,estrodetox,http://goodpreview.info/estrodetox,94,97,-3
03:04:2014,extentxl,http://goodpreview.info/extentxl,173,173,0
03:04:2014,fembalance,http://goodpreview.info/fembalance,17,17,0
03:04:2014,flawlessraspberryketone,http://goodpreview.info/flawlessraspberryketone,79,79,0
03:04:2014,formulat10,http://goodpreview.info/formulat10,1500,1503,-3
03:04:2014,garcinaiawow1,http://goodpreview.info/garcinaiawow1,18,36,-18
03:04:2014,garciniacambogia,http://goodpreview.info/garciniacambogia,57,142,-85
03:04:2014,garciniacambogia1000,http://goodpreview.info/garciniacambogia1000,61,61,0
03:04:2014,garciniacambogiaelite,http://goodpreview.info/garciniacambogiaelite,5179,5215,-36
03:04:2014,garciniacambogiafatbuster,http://goodpreview.info/garciniacambogiafatbuster,90,90,0
03:04:2014,garciniacambogiamax,http://goodpreview.info/garciniacambogiamax,2401,2402,-1
03:04:2014,garciniacambogiamiracle,http://goodpreview.info/garciniacambogiamiracle,128,128,0
03:04:2014,garciniacambogiapremium,http://goodpreview.info/garciniacambogiapremium,1075,1075,0
03:04:2014,garciniacambogiapureextract,http://goodpreview.info/garciniacambogiapureextract,140,141,-1
03:04:2014,garciniacambogiapureselect,http://goodpreview.info/garciniacambogiapureselect,579,587,-8
03:04:2014,garciniacambogiasupreme,http://goodpreview.info/garciniacambogiasupreme,2875,2975,-100
03:04:2014,garciniacambogiatoday,http://goodpreview.info/garciniacambogiatoday,120,125,-5
03:04:2014,garciniacambogiaultra,http://goodpreview.info/garciniacambogiaultra,355,356,-1
03:04:2014,garciniaforte,http://goodpreview.info/garciniaforte,2657,2675,-18
03:04:2014,garciniafreetrial,http://goodpreview.info/garciniafreetrial,67,67,0
03:04:2014,garciniagreen,http://goodpreview.info/garciniagreen,830,831,-1
03:04:2014,garciniapureelite1,http://goodpreview.info/garciniapureelite1,1,1,0
03:04:2014,garciniatoday,http://goodpreview.info/garciniatoday,0,0,0
03:04:2014,garciniatotal,http://goodpreview.info/garciniatotal,84,87,-3
03:04:2014,garciniawow,http://goodpreview.info/garciniawow,759,809,-50
03:04:2014,garcinium,http://goodpreview.info/garcinium,144,19,125
03:04:2014,gc7x,http://goodpreview.info/gc7x,102,102,0
03:04:2014,gc7xgreencoffee,http://goodpreview.info/gc7xgreencoffee,0,0,0
03:04:2014,gcbultra,http://goodpreview.info/gcbultra,51,51,0
03:04:2014,gcbx,http://goodpreview.info/gcbx,17063,17070,-7
03:04:2014,gcbx1,http://goodpreview.info/gcbx1,196,196,0
03:04:2014,gcspeedslim,http://goodpreview.info/gcspeedslim,5656,5679,-23
03:04:2014,gcultra,http://goodpreview.info/gcultra,135,135,0
03:04:2014,gcultragarcinia,http://goodpreview.info/gcultragarcinia,4,4,0
03:04:2014,geneme,http://goodpreview.info/geneme,39,39,0
03:04:2014,getnaturalgarcinia,http://goodpreview.info/getnaturalgarcinia,40,40,0
03:04:2014,greencoffeeadvanced,http://goodpreview.info/greencoffeeadvanced,181,181,0
03:04:2014,greencoffeebean8000,http://goodpreview.info/greencoffeebean8000,66,66,0
03:04:2014,greencoffeebody,http://goodpreview.info/greencoffeebody,33,33,0
03:04:2014,greencoffeeburn,http://goodpreview.info/greencoffeeburn,22,22,0
03:04:2014,greencoffeeextreme,http://goodpreview.info/greencoffeeextreme,84,84,0
03:04:2014,greencoffeemax,http://goodpreview.info/greencoffeemax,126,127,-1
03:04:2014,greencoffeemaxx,http://goodpreview.info/greencoffeemaxx,3,3,0
03:04:2014,greencoffeeoptimum,http://goodpreview.info/greencoffeeoptimum,122,122,0
03:04:2014,greencoffeeprogram,http://goodpreview.info/greencoffeeprogram,0,0,0
03:04:2014,greencoffeeultraslim,http://goodpreview.info/greencoffeeultraslim,205,205,0
03:04:2014,greentonepro,http://goodpreview.info/greentonepro,308,308,0
03:04:2014,healthetrimgarcinia,http://goodpreview.info/healthetrimgarcinia,151,151,0
03:04:2014,healthychoicegc,http://goodpreview.info/healthychoicegc,737,741,-4
03:04:2014,horsepowerplusxxxl,http://goodpreview.info/horsepowerplusxxxl,167,179,-12
03:04:2014,hugegenic,http://goodpreview.info/hugegenic,268,284,-16
03:04:2014,hydrellatone,http://goodpreview.info/hydrellatone,102,102,0
03:04:2014,hydrocollagen,http://goodpreview.info/hydrocollagen,42,42,0
03:04:2014,hydroderm,http://goodpreview.info/hydroderm,43,43,0
03:04:2014,hyperfuel9x,http://goodpreview.info/hyperfuel9x,1899,1903,-4
03:04:2014,illuminatedteeth,http://goodpreview.info/illuminatedteeth,35,40,-5
03:04:2014,instantwrinklerepair,http://goodpreview.info/instantwrinklerepair,18,18,0
03:04:2014,iqderma,http://goodpreview.info/iqderma,410,413,-3
03:04:2014,iqdermaessen,http://goodpreview.info/iqdermaessen,0,0,0
03:04:2014,ketoneoptimum,http://goodpreview.info/ketoneoptimum,150,151,-1
03:04:2014,kleanslim,http://goodpreview.info/kleanslim,99,99,0
03:04:2014,lacreme,http://goodpreview.info/lacreme,744,751,-7
03:04:2014,leanmuscleformula,http://goodpreview.info/leanmuscleformula,16,20,-4
03:04:2014,ledermeluxe,http://goodpreview.info/ledermeluxe,185,185,0
03:04:2014,leparfait,http://goodpreview.info/leparfait,13,15,-2
03:04:2014,leparisehydragold,http://goodpreview.info/leparisehydragold,58,0,58
03:04:2014,levela,http://goodpreview.info/levela,102,105,-3
03:04:2014,lifedetox,http://goodpreview.info/lifedetox,145,145,0
03:04:2014,liftserumpro,http://goodpreview.info/liftserumpro,181,182,-1
03:04:2014,liposlender,http://goodpreview.info/liposlender,23,23,0
03:04:2014,liposlim,http://goodpreview.info/liposlim,1851,1854,-3
03:04:2014,liposom,http://goodpreview.info/liposom,60,60,0
03:04:2014,liveskinny,http://goodpreview.info/liveskinny,232,232,0
03:04:2014,lumahydrate,http://goodpreview.info/lumahydrate,348,361,-13
03:04:2014,lumarepair,http://goodpreview.info/lumarepair,448,451,-3
03:04:2014,lunathin,http://goodpreview.info/lunathin,122,122,0
03:04:2014,luxoderm,http://goodpreview.info/luxoderm,190,196,-6
03:04:2014,lysocleanse,http://goodpreview.info/lysocleanse,1726,1739,-13
03:04:2014,maxdetoxpro,http://goodpreview.info/maxdetoxpro,571,574,-3
03:04:2014,maxgarciniaburn,http://goodpreview.info/maxgarciniaburn,455,455,0
03:04:2014,maximumshred,http://goodpreview.info/maximumshred,1509,1513,-4
03:04:2014,maxrobust,http://goodpreview.info/maxrobust,246,250,-4
03:04:2014,maxrobustxtreme,http://goodpreview.info/maxrobustxtreme,520,520,0
03:04:2014,mightyraspberryketone,http://goodpreview.info/mightyraspberryketone,5088,5097,-9
03:04:2014,miraclegarciniacambogia,http://goodpreview.info/miraclegarciniacambogia,465,473,-8
03:04:2014,miraclegreencoffee,http://goodpreview.info/miraclegreencoffee,443,462,-19
03:04:2014,miraclesaffron,http://goodpreview.info/miraclesaffron,42,46,-4
03:04:2014,mitoslim,http://goodpreview.info/mitoslim,2050,2050,0
03:04:2014,musclefactorx,http://goodpreview.info/musclefactorx,1427,1428,-1
03:04:2014,musclefactorx-1,http://goodpreview.info/musclefactorx-1,20,20,0
03:04:2014,musclekingpro,http://goodpreview.info/musclekingpro,499,499,0
03:04:2014,musclemaxextreme,http://goodpreview.info/musclemaxextreme,136,137,-1
03:04:2014,muscleplus,http://goodpreview.info/muscleplus,139,139,0
03:04:2014,musclerevolutionpro,http://goodpreview.info/musclerevolutionpro,1390,1393,-3
03:04:2014,musclerevx,http://goodpreview.info/musclerevx,76,79,-3
03:04:2014,musclerevxtreme,http://goodpreview.info/musclerevxtreme,56,57,-1
03:04:2014,musclexlerator,http://goodpreview.info/musclexlerator,18,19,-1
03:04:2014,musclexmax,http://goodpreview.info/musclexmax,1375,1394,-19
03:04:2014,musclexmax1,http://goodpreview.info/musclexmax1,272,275,-3
03:04:2014,musclezx90,http://goodpreview.info/musclezx90,4930,4935,-5
03:04:2014,naturalcleanse,http://goodpreview.info/naturalcleanse,7963,7978,-15
03:04:2014,naturalgarciniacambogia,http://goodpreview.info/naturalgarciniacambogia,2747,2751,-4
03:04:2014,naturalgreencoffee,http://goodpreview.info/naturalgreencoffee,7,7,0
03:04:2014,naturalhealthgarcinia,http://goodpreview.info/naturalhealthgarcinia,47,47,0
03:04:2014,naturalpurecleanse,http://goodpreview.info/naturalpurecleanse,1519,1528,-9
03:04:2014,nauseam,http://goodpreview.info/nauseam,133,133,0
03:04:2014,nauseamplus,http://goodpreview.info/nauseamplus,0,0,0
03:04:2014,nextrim,http://goodpreview.info/nextrim,1719,1720,-1
03:04:2014,nitricmusclemax,http://goodpreview.info/nitricmusclemax,13063,13213,-150
03:04:2014,nitrofocusno3,http://goodpreview.info/nitrofocusno3,61,64,-3
03:04:2014,niwali,http://goodpreview.info/niwali,796,802,-6
03:04:2014,no2explodeextreme,http://goodpreview.info/no2explodeextreme,159,159,0
03:04:2014,no2extremerush,http://goodpreview.info/no2extremerush,1296,1296,0
03:04:2014,noflameecigs,http://goodpreview.info/noflameecigs,350,350,0
03:04:2014,nuclearno,http://goodpreview.info/nuclearno,364,365,-1
03:04:2014,nuetrim,http://goodpreview.info/nuetrim,658,658,0
03:04:2014,nutragreencoffee,http://goodpreview.info/nutragreencoffee,3519,3529,-10
03:04:2014,nutrapuregarcinia,http://goodpreview.info/nutrapuregarcinia,205,206,-1
03:04:2014,nutratoneplus,http://goodpreview.info/nutratoneplus,989,993,-4
03:04:2014,nutriberryslim,http://goodpreview.info/nutriberryslim,1041,1063,-22
03:04:2014,nuvoryn,http://goodpreview.info/nuvoryn,22,22,0
03:04:2014,optimalstack,http://goodpreview.info/optimalstack,1631,1639,-8
03:04:2014,optimummuscle,http://goodpreview.info/optimummuscle,202,202,0
03:04:2014,organicgreencoffee,http://goodpreview.info/organicgreencoffee,90,90,0
03:04:2014,organicwhitekidneybean,http://goodpreview.info/organicwhitekidneybean,90,90,0
03:04:2014,orviax,http://goodpreview.info/orviax,88,88,0
03:04:2014,oxitamin,http://goodpreview.info/oxitamin,146,146,0
03:04:2014,phtytoceramides,http://goodpreview.info/phtytoceramides,787,791,-4
03:04:2014,powerigf,http://goodpreview.info/powerigf,1719,1749,-30
03:04:2014,powerpumpxl,http://goodpreview.info/powerpumpxl,365,366,-1
03:04:2014,powerup,http://goodpreview.info/powerup,114,115,-1
03:04:2014,premiermangocleanse,http://goodpreview.info/premiermangocleanse,509,511,-2
03:04:2014,premiumcleanse,http://goodpreview.info/premiumcleanse,2719,2729,-10
03:04:2014,premiumgarciniacambogia,http://goodpreview.info/premiumgarciniacambogia,397,398,-1
03:04:2014,premiumgarciniaextract,http://goodpreview.info/premiumgarciniaextract,689,701,-12
03:04:2014,premiumgreencoffee,http://goodpreview.info/premiumgreencoffee,119,119,0
03:04:2014,premiumgreencoffee800,http://goodpreview.info/premiumgreencoffee800,107,108,-1
03:04:2014,premiumraspberryketone,http://goodpreview.info/premiumraspberryketone,43,43,0
03:04:2014,primalitegarciniaextract,http://goodpreview.info/primalitegarciniaextract,696,704,-8
03:04:2014,progain350,http://goodpreview.info/progain350,199,207,-8
03:04:2014,prograce,http://goodpreview.info/prograce,3,3,0
03:04:2014,promusclecomplex,http://goodpreview.info/promusclecomplex,49,49,0
03:04:2014,propowercleanse,http://goodpreview.info/propowercleanse,921,973,-52
03:04:2014,pureberrymax,http://goodpreview.info/pureberrymax,214,214,0
03:04:2014,purecleansehealth,http://goodpreview.info/purecleansehealth,107,107,0
03:04:2014,purecollagen,http://goodpreview.info/purecollagen,2211,2220,-9
03:04:2014,puregarciniacambogia,http://goodpreview.info/puregarciniacambogia,1202,1205,-3
03:04:2014,puregarciniaslim,http://goodpreview.info/puregarciniaslim,135,145,-10
03:04:2014,puregreencoffeebeanextract,http://goodpreview.info/puregreencoffeebeanextract,2697,2701,-4
03:04:2014,puregreencoffeemaxima,http://goodpreview.info/puregreencoffeemaxima,37,37,0
03:04:2014,puregriffonia,http://goodpreview.info/puregriffonia,96,96,0
03:04:2014,pureketoneslim,http://goodpreview.info/pureketoneslim,29,30,-1
03:04:2014,purelifeclanse,http://goodpreview.info/purelifeclanse,2,6,-4
03:04:2014,puremusclepro,http://goodpreview.info/puremusclepro,1800,1800,0
03:04:2014,purenaturalcleanser,http://goodpreview.info/purenaturalcleanser,477,477,0
03:04:2014,purephytoceramides,http://goodpreview.info/purephytoceramides,70,73,-3
03:04:2014,pureraspberryketonepremium,http://goodpreview.info/pureraspberryketonepremium,62,62,0
03:04:2014,puresaffronslim,http://goodpreview.info/puresaffronslim,422,423,-1
03:04:2014,pureslim57,http://goodpreview.info/pureslim57,125,126,-1
03:04:2014,purgarciniacambogia,http://goodpreview.info/purgarciniacambogia,156,157,-1
03:04:2014,purgreencoffee,http://goodpreview.info/purgreencoffee,1625,1626,-1
03:04:2014,purifyre,http://goodpreview.info/purifyre,243,244,-1
03:04:2014,purifyregreencoffee,http://goodpreview.info/purifyregreencoffee,0,0,0
03:04:2014,raspberryhealth,http://goodpreview.info/raspberryhealth,51,56,-5
03:04:2014,raspberryketoneblast,http://goodpreview.info/raspberryketoneblast,4050,4087,-37
03:04:2014,raspberryketoned,http://goodpreview.info/raspberryketoned,2,2,0
03:04:2014,raspberryketoneoptimum,http://goodpreview.info/raspberryketoneoptimum,5,5,0
03:04:2014,raspberryketonepremium,http://goodpreview.info/raspberryketonepremium,77,77,0
03:04:2014,raspberryketonepure,http://goodpreview.info/raspberryketonepure,2,2,0
03:04:2014,raspberryketonethin,http://goodpreview.info/raspberryketonethin,417,435,-18
03:04:2014,raspberryslimplus,http://goodpreview.info/raspberryslimplus,125,125,0
03:04:2014,refuelextreme,http://goodpreview.info/refuelextreme,466,470,-4
03:04:2014,regalecig,http://goodpreview.info/regalecig,361,364,-3
03:04:2014,regalecigs,http://goodpreview.info/regalecigs,40,40,0
03:04:2014,rejuvaglow,http://goodpreview.info/rejuvaglow,70,70,0
03:04:2014,rejuveneyemax,http://goodpreview.info/rejuveneyemax,19,33,-14
03:04:2014,rellift,http://goodpreview.info/rellift,29,29,0
03:04:2014,renovo,http://goodpreview.info/renovo,33,37,-4
03:04:2014,restiflex,http://goodpreview.info/restiflex,62,62,0
03:04:2014,revitalize,http://goodpreview.info/revitalize,25,25,0
03:04:2014,revitatone,http://goodpreview.info/revitatone,8784,8827,-43
03:04:2014,revolutionaryraspberryketone,http://goodpreview.info/revolutionaryraspberryketone,65,65,0
03:04:2014,revoreplex,http://goodpreview.info/revoreplex,114,2,112
03:04:2014,revtesttestosterone,http://goodpreview.info/revtesttestosterone,1590,1591,-1
03:04:2014,rippedmusclex,http://goodpreview.info/rippedmusclex,159,168,-9
03:04:2014,rippedxburn,http://goodpreview.info/rippedxburn,183,183,0
03:04:2014,sacredarganoil,http://goodpreview.info/sacredarganoil,45,45,0
03:04:2014,safercolon,http://goodpreview.info/safercolon,2969,3000,-31
03:04:2014,saffronextractpremium,http://goodpreview.info/saffronextractpremium,105,105,0
03:04:2014,saffronextractselect,http://goodpreview.info/saffronextractselect,1345,1350,-5
03:04:2014,saffronselect,http://goodpreview.info/saffronselect,72,72,0
03:04:2014,secretgreencoffee,http://goodpreview.info/secretgreencoffee,254,256,-2
03:04:2014,simpleantiaging,http://goodpreview.info/simpleantiaging,227,228,-1
03:04:2014,simplygarcinia,http://goodpreview.info/simplygarcinia,1044,1070,-26
03:04:2014,skinlift,http://goodpreview.info/skinlift,2145,2145,0
03:04:2014,slendera,http://goodpreview.info/slendera,15,15,0
03:04:2014,slenderagc-1,http://goodpreview.info/slenderagc-1,388,392,-4
03:04:2014,slimatrex,http://goodpreview.info/slimatrex,610,613,-3
03:04:2014,slimhelper,http://goodpreview.info/slimhelper,245,245,0
03:04:2014,slimher,http://goodpreview.info/slimher,171,171,0
03:04:2014,slimmeryougarcinia,http://goodpreview.info/slimmeryougarcinia,0,0,0
03:04:2014,slimtropical,http://goodpreview.info/slimtropical,803,805,-2
03:04:2014,slimtropicalmx,http://goodpreview.info/slimtropicalmx,133,134,-1
03:04:2014,slimzenu,http://goodpreview.info/slimzenu,198,200,-2
03:04:2014,smokestarecig,http://goodpreview.info/smokestarecig,511,543,-32
03:04:2014,solpriaxtreme,http://goodpreview.info/solpriaxtreme,2769,2774,-5
03:04:2014,sorepressin,http://goodpreview.info/sorepressin,6,6,0
03:04:2014,speedtrimxs,http://goodpreview.info/speedtrimxs,93,95,-2
03:04:2014,splendyr,http://goodpreview.info/splendyr,1272,1273,-1
03:04:2014,splendyrantiaging,http://goodpreview.info/splendyrantiaging,51,51,0
03:04:2014,superacaicleanse,http://goodpreview.info/superacaicleanse,20,20,0
03:04:2014,supercleansetotal,http://goodpreview.info/supercleansetotal,62,63,-1
03:04:2014,supergreencoffee,http://goodpreview.info/supergreencoffee,11,11,0
03:04:2014,supergreencoffeebean,http://goodpreview.info/supergreencoffeebean,20,20,0
03:04:2014,superiormusclex,http://goodpreview.info/superiormusclex,82,92,-10
03:04:2014,superiorvelvet,http://goodpreview.info/superiorvelvet,1,1,0
03:04:2014,superyacon1000,http://goodpreview.info/superyacon1000,19,20,-1
03:04:2014,supracleanse350,http://goodpreview.info/supracleanse350,0,0,0
03:04:2014,supragreencoffee,http://goodpreview.info/supragreencoffee,891,900,-9
03:04:2014,supragreencoffeebean,http://goodpreview.info/supragreencoffeebean,0,0,0
03:04:2014,surelyyoung,http://goodpreview.info/surelyyoung,29,29,0
03:04:2014,swissrose,http://goodpreview.info/swissrose,338,340,-2
03:04:2014,swolekreate,http://goodpreview.info/swolekreate,191,192,-1
03:04:2014,syneocell,http://goodpreview.info/syneocell,54,54,0
03:04:2014,t-force,http://goodpreview.info/t-force,184,186,-2
03:04:2014,testforcextreme,http://goodpreview.info/testforcextreme,487,488,-1
03:04:2014,testoforce,http://goodpreview.info/testoforce,13,14,-1
03:04:2014,testorushrx,http://goodpreview.info/testorushrx,38,38,0
03:04:2014,testosteronemax,http://goodpreview.info/testosteronemax,327,328,-1
03:04:2014,testoxl,http://goodpreview.info/testoxl,1459,1465,-6
03:04:2014,thinmagic,http://goodpreview.info/thinmagic,260,269,-9
03:04:2014,thinmagicmax,http://goodpreview.info/thinmagicmax,0,0,0
03:04:2014,thinsport,http://goodpreview.info/thinsport,211,211,0
03:04:2014,titaniumprox,http://goodpreview.info/titaniumprox,0,0,0
03:04:2014,totalbodyfresh,http://goodpreview.info/totalbodyfresh,111,112,-1
03:04:2014,trigx2,http://goodpreview.info/trigx2,7,9,-2
03:04:2014,trimaleana,http://goodpreview.info/trimaleana,142,142,0
03:04:2014,trimatol,http://goodpreview.info/trimatol,120,121,-1
03:04:2014,trimblendgarciniacambogia,http://goodpreview.info/trimblendgarciniacambogia,72,72,0
03:04:2014,triminexgarciniacambogia,http://goodpreview.info/triminexgarciniacambogia,82,84,-2
03:04:2014,triminexgreencoffee,http://goodpreview.info/triminexgreencoffee,50,52,-2
03:04:2014,tripleeffectseyeserum,http://goodpreview.info/tripleeffectseyeserum,594,598,-4
03:04:2014,turboextracut,http://goodpreview.info/turboextracut,157,158,-1
03:04:2014,turboshred,http://goodpreview.info/turboshred,100,100,0
03:04:2014,ultimategarcinia,http://goodpreview.info/ultimategarcinia,164,164,0
03:04:2014,ultramaxtestosterone,http://goodpreview.info/ultramaxtestosterone,33,33,0
03:04:2014,ultrapurecoloncleanse,http://goodpreview.info/ultrapurecoloncleanse,353,1,352
03:04:2014,ultraraspberryketone,http://goodpreview.info/ultraraspberryketone,418,418,0
03:04:2014,velora,http://goodpreview.info/velora,23,23,0
03:04:2014,velveskin,http://goodpreview.info/velveskin,12,14,-2
03:04:2014,vencleanse,http://goodpreview.info/vencleanse,429,429,0
03:04:2014,viarex,http://goodpreview.info/viarex,596,598,-2
03:04:2014,vitalifedetox,http://goodpreview.info/vitalifedetox,254,254,0
03:04:2014,vitalitygreencoffee,http://goodpreview.info/vitalitygreencoffee,84,85,-1
03:04:2014,vitamax,http://goodpreview.info/vitamax,22,22,0
03:04:2014,vitolipo,http://goodpreview.info/vitolipo,1126,1131,-5
03:04:2014,vydox,http://goodpreview.info/vydox,295,302,-7
03:04:2014,wildraspberryketone,http://goodpreview.info/wildraspberryketone,166,169,-3
03:04:2014,wrinklesscream,http://goodpreview.info/wrinklesscream,266,270,-4
03:04:2014,xenaslim,http://goodpreview.info/xenaslim,40,41,-1
03:04:2014,xengthx1,http://goodpreview.info/xengthx1,30,30,0
03:04:2014,xlerator,http://goodpreview.info/xlerator,0,0,0
03:04:2014,xocigs,http://goodpreview.info/xocigs,64,64,0
03:04:2014,xtgenix,http://goodpreview.info/xtgenix,12921,12941,-20
03:04:2014,xtrememusclepro,http://goodpreview.info/xtrememusclepro,606,607,-1
03:04:2014,yaconsplash,http://goodpreview.info/yaconsplash,20,21,-1
03:04:2014,yaconsyruporiginal,http://goodpreview.info/yaconsyruporiginal,94,94,0
03:04:2014,yaconsyrupsecret,http://goodpreview.info/yaconsyrupsecret,32,32,0
03:04:2014,yoloboost,http://goodpreview.info/yoloboost,145,2,143
03:04:2014,youthkiteyecream,http://goodpreview.info/youthkiteyecream,241,242,-1
